wind_speed,wdir,smois,ignition_pattern,fire_behavior,inside_area,outside_area,burned_area,FILE
2,180,0.05,0,0,120852,1536,122388,images/run_07127fcc-66c4-4498-a4c6-8e9f6e5fbe68_fuels-dens_2100_000.png
8,225,0.05,0,1,121306,47996,169302,images/run_cd34e198-92d8-465d-b7d7-9cdf8b4dbd12_fuels-dens_2100_000.png
8,195,0.05,0,1,135427,52115,187542,images/run_16f771f5-b830-4c22-962a-e5074d90c9c4_fuels-dens_2100_000.png
5,240,0.05,0,1,135424,46159,181583,images/run_11bea928-97ce-4188-80b9-06eda10d0a2b_fuels-dens_2100_000.png
8,225,0.05,0,1,121372,47583,168955,images/run_e60409b6-fb4e-4657-98e9-74610660014b_fuels-dens_2100_000.png
8,225,0.05,1,1,135420,52154,187574,images/run_aad3bb47-75f1-4db5-b4c6-d09368585317_fuels-dens_2100_000.png
8,225,0.05,0,1,135425,49601,185026,images/run_e1ad0175-130d-413d-8293-31e9ba2ced77_fuels-dens_2100_000.png
3,180,0.05,0,0,135426,26817,162243,images/run_90c51041-296a-4977-a2da-d764d7d8165d_fuels-dens_2100_000.png
12,255,0.05,0,1,135416,47819,183235,images/run_d28f79ae-24b7-45aa-a95d-dd2f1333f4a2_fuels-dens_2100_000.png
12,240,0.05,0,1,135419,48476,183895,images/run_60c66649-b8a1-449c-82cb-acc12c6f7ad9_fuels-dens_2100_000.png
3,225,0.05,0,1,135427,33847,169274,images/run_310aeb02-0def-4e5a-a004-d16725815b85_fuels-dens_2100_000.png
3,195,0.05,0,0,135427,13664,149091,images/run_c06b62c2-cce4-4a02-8e3c-6433261594c6_fuels-dens_2100_000.png
12,255,0.05,0,1,135372,48131,183503,images/run_e3f4c121-e202-450e-9152-0ec0a28318ff_fuels-dens_2100_000.png
12,255,0.05,1,1,135397,38191,173588,images/run_d9cb6639-a32d-4783-965c-f1389c06bd14_fuels-dens_2100_000.png
8,240,0.05,0,1,121248,47961,169209,images/run_00ddce4e-2b42-499c-a8c7-3642b206eee5_fuels-dens_2100_000.png
8,240,0.05,0,1,135426,48854,184280,images/run_cc0c4fa2-92a2-49bd-bb76-a19b3b7f4da5_fuels-dens_2100_000.png
8,240,0.05,0,1,135426,47661,183087,images/run_ebb86825-dbb9-4992-8544-38dcdcff9d28_fuels-dens_2100_000.png
12,255,0.05,0,1,121179,48417,169596,images/run_3657dcc7-0863-4db4-8936-e0ced230c013_fuels-dens_2100_000.png
12,180,0.05,1,1,135423,51089,186512,images/run_1ebf8029-7b17-4b13-8964-aa4e3a471e25_fuels-dens_2100_000.png
12,180,0.05,0,1,122035,48807,170842,images/run_78303682-4427-42c4-a947-d4405aafadaf_fuels-dens_2100_000.png
12,195,0.05,0,1,122597,50215,172812,images/run_495ba59f-860f-463b-8faa-92ff5a3959c2_fuels-dens_2100_000.png
12,195,0.05,1,1,135406,52899,188305,images/run_4f9b151b-f1dd-4ab9-947e-b2cd0c21084a_fuels-dens_2100_000.png
12,195,0.05,0,1,135410,50598,186008,images/run_8d0f252d-198a-4347-9144-c693103b0a34_fuels-dens_2100_000.png
12,225,0.05,0,1,121170,48541,169711,images/run_7fb7652e-2451-4382-94aa-80ee89fba33e_fuels-dens_2100_000.png
2,180,0.05,0,0,121175,4180,125355,images/run_686301e8-e86f-41b0-8e68-4d0bd98e6e41_fuels-dens_2100_000.png
12,225,0.05,1,1,135400,52145,187545,images/run_08fe9400-6dc4-41bd-896c-e69d14ad9587_fuels-dens_2100_000.png
8,255,0.05,0,1,135426,47283,182709,images/run_a3f75b42-bb4e-4622-8777-07711b1f49f4_fuels-dens_2100_000.png
8,255,0.05,1,1,135425,35347,170772,images/run_14d26113-851a-40e1-92fa-65f0eceb1bf6_fuels-dens_2100_000.png
8,255,0.05,0,1,120991,36618,157609,images/run_ea5c52fb-284b-4b50-9d8b-d2367b822bef_fuels-dens_2100_000.png
12,240,0.05,1,1,121169,48582,169751,images/run_50772e14-9ef0-4395-8a70-8e7bb15fcce3_fuels-dens_2100_000.png
12,240,0.05,1,1,135416,51269,186685,images/run_6f73be4e-b9da-4f52-9a9f-115344fc9a05_fuels-dens_2100_000.png
12,240,0.05,0,1,135379,49419,184798,images/run_07597bb1-219b-4f9f-a01b-8218605bfed5_fuels-dens_2100_000.png
12,225,0.05,0,1,135396,50652,186048,images/run_a0603b78-4db8-465a-ba4c-5f361dac1dcc_fuels-dens_2100_000.png
12,180,0.05,0,1,135422,49384,184806,images/run_0dd31a6f-45e7-4afd-a0fb-4657cba155e0_fuels-dens_2100_000.png
2,180,0.05,0,0,135426,14945,150371,images/run_caa7d8be-f36b-46bf-b33b-5ec5e8eaa7e9_fuels-dens_2100_000.png
8,195,0.05,0,1,135427,49668,185095,images/run_f67173e8-7c68-4620-9987-35cde51847c7_fuels-dens_2100_000.png
5,225,0.05,0,1,135427,50914,186341,images/run_8aab1e2d-4098-4f93-a0d1-422273c1ee82_fuels-dens_2100_000.png
5,225,0.05,0,1,135427,46882,182309,images/run_7b4cbc51-3293-4763-a67b-96b8ee050ef2_fuels-dens_2100_000.png
3,195,0.05,0,0,135275,17414,152689,images/run_6792fcd4-30de-4694-8b0a-cfb8b38c9353_fuels-dens_2100_000.png
3,195,0.05,0,0,135416,30308,165724,images/run_3b04e426-074e-4bb5-a1e4-97cb6ca278bc_fuels-dens_2100_000.png
3,195,0.05,0,0,120543,8135,128678,images/run_116d7d39-77d2-4f6d-bcf0-fe6305e14df6_fuels-dens_2100_000.png
3,180,0.05,0,0,135425,18799,154224,images/run_ea0c2dd3-dfea-4984-96ee-2ff7d9d6f2b9_fuels-dens_2100_000.png
3,180,0.05,0,0,135410,23847,159257,images/run_16beb53c-ac02-4081-81e1-e3792cc2e1de_fuels-dens_2100_000.png
5,240,0.05,0,1,135427,48490,183917,images/run_672bbee2-a941-4c4d-8056-91011ed67310_fuels-dens_2100_000.png
5,240,0.05,0,1,135426,46623,182049,images/run_47fdb0a8-1b87-4213-9c75-bec604edacc2_fuels-dens_2100_000.png
3,180,0.05,0,0,120883,6807,127690,images/run_783b1e9b-4c35-4310-a3ce-4ed177bd6e28_fuels-dens_2100_000.png
2,255,0.05,0,1,135401,10625,146026,images/run_bfed30ad-2910-4406-a67c-1fb19b719516_fuels-dens_2100_000.png
2,255,0.05,0,1,135415,18215,153630,images/run_eb7ab7c6-3fc1-4523-9865-92a71d37ebea_fuels-dens_2100_000.png
2,255,0.05,0,0,119559,0,119559,images/run_0477232e-2bc8-43e7-a6ab-368ecb45ac27_fuels-dens_2100_000.png
5,255,0.05,0,1,120619,14648,135267,images/run_4242714d-3fbe-4c7c-9e64-67a86792c149_fuels-dens_2100_000.png
5,255,0.05,0,1,135427,44994,180421,images/run_e51f0c5d-1367-487e-ace1-ba48349077b7_fuels-dens_2100_000.png
8,195,0.05,0,1,135427,51948,187375,images/run_a9495aaf-4300-4505-b1a4-f91b286c5e58_fuels-dens_2100_000.png
8,195,0.05,0,1,121249,48825,170074,images/run_edbc33e5-4de7-4e15-8a7c-8b1e323e2360_fuels-dens_2100_000.png
2,195,0.05,0,0,120642,4087,124729,images/run_cdcfb066-cdf4-42b9-8d4e-7f0dc145df0f_fuels-dens_2100_000.png
2,195,0.05,0,1,135425,17014,152439,images/run_5bbd2124-4f73-4d23-8f73-b69043832a6a_fuels-dens_2100_000.png
2,195,0.05,0,1,135388,13354,148742,images/run_71081eaf-d0de-43fd-a896-860eaa2aba78_fuels-dens_2100_000.png
2,225,0.05,0,1,120128,1740,121868,images/run_99718019-1491-44c5-bac5-a3f4ab72b456_fuels-dens_2100_000.png
2,180,0.05,0,0,135406,10938,146344,images/run_e4a2c59e-cf87-4272-a2fc-84a2c1347ddf_fuels-dens_2100_000.png
8,180,0.05,1,1,135426,48088,183514,images/run_9793d952-4099-46a9-b71b-a8886eae3e1d_fuels-dens_2100_000.png
3,180,0.05,0,1,135413,20691,156104,images/run_fe8888bd-e110-4d66-b33d-7c152259f9a8_fuels-dens_2100_000.png
2,225,0.05,0,0,135420,19678,155098,images/run_ef277141-3637-4610-852d-96464ca85df9_fuels-dens_2100_000.png
2,225,0.05,0,1,135273,10766,146039,images/run_b86d9989-e431-476a-b1f1-40df0cc4532f_fuels-dens_2100_000.png
2,240,0.05,0,1,119981,1460,121441,images/run_b4edcf32-e7ef-42c9-a1c0-1502be8c1cb8_fuels-dens_2100_000.png
2,240,0.05,0,1,135421,19460,154881,images/run_5334aa3f-033f-4dc7-91bc-1d2b82b6ae7a_fuels-dens_2100_000.png
2,240,0.05,0,1,135388,13778,149166,images/run_103cdd1e-d108-4f88-8b7e-fe840f21b85b_fuels-dens_2100_000.png
8,180,0.05,1,1,135426,51711,187137,images/run_6671ce14-f499-4722-8574-5ceaddaf5f3a_fuels-dens_2100_000.png
5,225,0.05,0,1,120884,33488,154372,images/run_dea6770b-a3cb-4013-ba49-be7ab68f1034_fuels-dens_2100_000.png
12,180,0.05,1,1,135415,49262,184677,images/run_110f2e20-b8ac-42f8-9ed2-e3723cbecdd5_fuels-dens_2100_000.png
12,180,0.05,1,1,120989,49402,170391,images/run_8cad5161-9e15-4493-8f9c-83cd79979904_fuels-dens_2100_000.png
2,195,0.05,0,1,120306,3750,124056,images/run_76c21f3f-9da5-4fa6-8995-fb882f880271_fuels-dens_2100_000.png
2,195,0.05,0,1,135427,16021,151448,images/run_2f79df5f-61f2-4006-a781-d9ea5c163ac5_fuels-dens_2100_000.png
2,195,0.05,0,1,135421,12984,148405,images/run_f593870f-dde7-4dca-a367-b19fe81f3994_fuels-dens_2100_000.png
5,195,0.05,0,1,135422,45375,180797,images/run_d568aa2d-6f7a-406a-92fb-9ac24064ebab_fuels-dens_2100_000.png
5,195,0.05,0,1,135424,50638,186062,images/run_549090ac-5f07-4f27-b4f0-a5bd921d71b2_fuels-dens_2100_000.png
5,195,0.05,0,1,120675,27829,148504,images/run_04c406e2-7a99-4ae5-99e4-d7449143f6d4_fuels-dens_2100_000.png
5,180,0.05,0,1,135427,39348,174775,images/run_1e967ac8-7bd8-4513-8a0d-1f4a21e59ef7_fuels-dens_2100_000.png
2,225,0.05,0,0,120060,1564,121624,images/run_0e029133-d031-43c0-ad85-3983315db7cf_fuels-dens_2100_000.png
2,225,0.05,0,1,135427,19789,155216,images/run_ca28486a-6bcb-4ea4-bb86-f35fd3ef98ba_fuels-dens_2100_000.png
2,225,0.05,0,1,135426,12544,147970,images/run_4473c5af-33bf-4e04-be3a-f9ab6465aa3c_fuels-dens_2100_000.png
5,180,0.05,0,1,135425,44927,180352,images/run_5c35f38d-ad5e-4c5c-a69e-6bd2914ec403_fuels-dens_2100_000.png
5,180,0.05,0,1,120795,19761,140556,images/run_c5ce2f2f-63dc-4a92-8db0-664289c9b094_fuels-dens_2100_000.png
3,255,0.05,0,1,135425,11338,146763,images/run_b728625e-04fe-44bb-9f7e-aa06267db457_fuels-dens_2100_000.png
3,255,0.05,0,1,135426,26787,162213,images/run_c9774089-891a-4544-a8d9-d3f48822de56_fuels-dens_2100_000.png
3,255,0.05,0,1,120159,5998,126157,images/run_a0796aec-b3a4-448d-8962-dd4f4f963580_fuels-dens_2100_000.png
2,240,0.05,0,0,119852,1631,121483,images/run_759cffb5-2d36-4147-947e-baa4256fa468_fuels-dens_2100_000.png
2,240,0.05,0,1,135426,19545,154971,images/run_52d268c0-8d3f-4b8d-abc9-e1bae7c483d4_fuels-dens_2100_000.png
3,180,0.05,0,1,120648,6781,127429,images/run_2ea18f87-4c83-4ae4-a151-81c8dcb898b6_fuels-dens_2100_000.png
3,195,0.05,0,1,120618,9356,129974,images/run_4af85152-40dd-48f1-a41d-e2824b461d73_fuels-dens_2100_000.png
3,195,0.05,0,1,135427,35095,170522,images/run_eecd2a65-3197-4853-9188-820454bd818f_fuels-dens_2100_000.png
3,195,0.05,0,1,135425,18496,153921,images/run_1a87ca2a-6118-435e-a109-a2adfcdb08f3_fuels-dens_2100_000.png
3,225,0.05,0,1,120292,4706,124998,images/run_550b3ea8-563c-4b1b-a139-116201242452_fuels-dens_2100_000.png
3,225,0.05,0,1,135424,37398,172822,images/run_adb85619-f691-4cc9-a6ec-0d16eb77d829_fuels-dens_2100_000.png
5,225,0.05,0,1,121018,34020,155038,images/run_ada2dfa8-eef1-44b3-8398-60f552303417_fuels-dens_2100_000.png
2,255,0.05,0,1,135412,10675,146087,images/run_01a23402-7463-4cfd-b4a8-2b7609d58071_fuels-dens_2100_000.png
2,255,0.05,0,1,119869,1339,121208,images/run_1ecf97bf-3f91-4de8-8276-19828a9b31d5_fuels-dens_2100_000.png
3,225,0.05,0,1,135427,19251,154678,images/run_f5299f0c-0695-42cc-8dcd-1436ff82eebe_fuels-dens_2100_000.png
3,240,0.05,0,1,120059,5999,126058,images/run_8d77872a-ecf9-4fb4-b6a9-0075fb501302_fuels-dens_2100_000.png
3,240,0.05,0,1,135426,35766,171192,images/run_8793ce89-4643-4f62-9b89-deb839d2713e_fuels-dens_2100_000.png
3,240,0.05,0,1,135425,19291,154716,images/run_f2fdec5d-b5b2-4bf6-bfb5-050c120f54ab_fuels-dens_2100_000.png
2,240,0.05,0,1,135424,12058,147482,images/run_1b24cb43-9504-43be-956f-505120870aa2_fuels-dens_2100_000.png
2,255,0.05,1,1,135426,17600,153026,images/run_39f1f8d5-e908-4f96-91cf-64d155a2f186_fuels-dens_2100_000.png
12,180,0.05,1,1,135415,51639,187054,images/run_57e51b66-9e66-4dfc-be59-3ddc4d4ae4fe_fuels-dens_2100_000.png
5,225,0.05,1,1,135421,48850,184271,images/run_391dc8a5-ebae-48c8-8ada-c04ff6079443_fuels-dens_2100_000.png
8,180,0.05,0,1,121050,33414,154464,images/run_26136ad9-63f5-485a-992c-38e66f1e635a_fuels-dens_2100_000.png
12,195,0.05,1,1,121317,50633,171950,images/run_a412b4f6-03e4-41b3-a8ee-f1f8494c8bc0_fuels-dens_2100_000.png
12,195,0.05,1,1,135425,52574,187999,images/run_54a040c6-65da-405f-a09f-38a865192180_fuels-dens_2100_000.png
12,195,0.05,1,1,135423,50366,185789,images/run_e48a79ba-b8b3-473a-90a2-0e622de9ddc8_fuels-dens_2100_000.png
8,255,0.05,0,1,135414,47158,182572,images/run_8c425acc-a22d-4d90-8fc6-f6a7f5bb558b_fuels-dens_2100_000.png
8,255,0.05,1,1,135420,48595,184015,images/run_6c4ff5ce-eb7e-49ec-9341-f5f9d89aab27_fuels-dens_2100_000.png
8,255,0.05,1,1,121082,39871,160953,images/run_4db89191-79fa-4e08-a842-004b7381431f_fuels-dens_2100_000.png
8,240,0.05,1,1,135420,48116,183536,images/run_99539356-35a2-402e-a048-9f4f2f3f384a_fuels-dens_2100_000.png
8,240,0.05,1,1,135417,51319,186736,images/run_f8fe2f6c-54bf-43e1-a220-052d95f7161f_fuels-dens_2100_000.png
12,225,0.05,1,1,121470,50730,172200,images/run_46493303-241d-4139-b4c1-18f6c72cb683_fuels-dens_2100_000.png
12,225,0.05,1,1,135421,52046,187467,images/run_3682627c-ba06-414b-a000-0464ee390b1d_fuels-dens_2100_000.png
12,225,0.05,1,1,135426,50888,186314,images/run_f1264518-0087-462c-9987-b77853008656_fuels-dens_2100_000.png
8,240,0.05,0,1,121233,48062,169295,images/run_d8428e41-5a32-4219-92cb-f4ded84c6e8d_fuels-dens_2100_000.png
8,225,0.05,1,1,135417,48107,183524,images/run_bf64ab09-1124-41dd-b788-9644c9e10358_fuels-dens_2100_000.png
8,225,0.05,1,1,135422,51954,187376,images/run_c46ddb36-f783-40f3-b078-a18609ac2882_fuels-dens_2100_000.png
12,240,0.05,1,1,121414,48569,169983,images/run_71e95e0d-2c17-425f-b256-1fa636341b41_fuels-dens_2100_000.png
12,240,0.05,1,1,135420,51569,186989,images/run_3aaf3961-60dd-4723-aaa8-b672d49c41f6_fuels-dens_2100_000.png
8,195,0.05,1,1,135421,49618,185039,images/run_3271683f-06f9-44b2-8fbf-1b77e3461a88_fuels-dens_2100_000.png
5,240,0.05,0,1,120897,31090,151987,images/run_3a63441b-ee36-43d8-8b2d-0e0497851bbb_fuels-dens_2100_000.png
2,180,0.05,0,1,135404,10839,146243,images/run_7a854189-05b9-4460-a6d6-a498b7d28171_fuels-dens_2100_000.png
2,180,0.05,0,1,135427,14431,149858,images/run_69daf27a-6343-4d3d-886e-a51ccf697db9_fuels-dens_2100_000.png
2,180,0.05,0,1,120529,1818,122347,images/run_a7b496a5-f11b-4546-a288-f5907557839d_fuels-dens_2100_000.png
5,240,0.05,1,1,135420,48907,184327,images/run_07d46add-71b8-4700-84ca-b48c4c1b7fd6_fuels-dens_2100_000.png
5,255,0.05,0,1,120748,16595,137343,images/run_2f6ce426-fa9f-42e3-9d0f-c9ca6d0eda41_fuels-dens_2100_000.png
5,225,0.05,1,1,135423,46957,182380,images/run_3e1efd4f-9391-4afe-ada1-955de886f518_fuels-dens_2100_000.png
5,255,0.05,1,1,135423,45317,180740,images/run_c7d64393-26c3-4231-a6db-c863382aac2a_fuels-dens_2100_000.png
12,255,0.05,1,1,135421,43178,178599,images/run_42a64ffa-2133-4a38-9a5b-e4a06f3459eb_fuels-dens_2100_000.png
12,255,0.05,1,1,121106,47891,168997,images/run_b33479a9-dec2-436a-acd5-65af833b8bc7_fuels-dens_2100_000.png
8,180,0.05,0,1,121044,40075,161119,images/run_f86fcafb-763e-4ad7-86be-fc2df3db2841_fuels-dens_2100_000.png
8,180,0.05,1,1,135414,51913,187327,images/run_911ffaca-8edc-4be9-99bd-f1809b7531b7_fuels-dens_2100_000.png
8,180,0.05,1,1,135415,48847,184262,images/run_b6d95ab7-8be7-42f7-a860-6aea07adbe5a_fuels-dens_2100_000.png
8,195,0.05,1,1,121073,47238,168311,images/run_08346a86-a2e7-48f7-bfdc-8bcb2ddb0625_fuels-dens_2100_000.png
5,255,0.05,0,1,135426,41176,176602,images/run_8fb5ee3f-be42-4750-85ce-02edbb54ead4_fuels-dens_2100_000.png
3,225,0.05,0,1,120326,6115,126441,images/run_5406ca4b-ed0d-43ed-8c54-58f738cc0d07_fuels-dens_2100_000.png
8,180,0.05,0,1,122077,31191,153268,images/run_de646778-2c81-4744-ba77-820d56d3cda1_fuels-dens_2100_000.png
3,240,0.05,0,1,119924,4541,124465,images/run_35900a02-1e3e-42a1-ae73-13718174f257_fuels-dens_2100_000.png
8,180,0.05,0,1,135416,51830,187246,images/run_b77f836a-97cf-464e-971c-9e5dbc8742d8_fuels-dens_2100_000.png
12,195,0.05,0,1,120896,50341,171237,images/run_ed88e8ab-ba7c-4ad2-a8d2-03ee04858e3e_fuels-dens_2100_000.png
12,195,0.05,1,1,135382,52975,188357,images/run_e9c948a8-680c-45b2-a162-98ebe9bf1ef8_fuels-dens_2100_000.png
12,195,0.05,1,1,135321,50048,185369,images/run_895a0942-6494-42e9-9eb2-fae03a75ccf2_fuels-dens_2100_000.png
3,225,0.05,0,1,120217,7196,127413,images/run_41043f8f-5261-4c5e-a848-e2750e14ca68_fuels-dens_2100_000.png
3,225,0.05,0,1,135427,16676,152103,images/run_86b88f50-1bae-4e7a-b503-6183c5073134_fuels-dens_2100_000.png
5,255,0.05,0,1,135420,39412,174832,images/run_6f5d6e2e-b6a5-4eb8-aa83-38b7e8b56395_fuels-dens_2100_000.png
5,255,0.05,0,1,135422,47595,183017,images/run_06007942-8dbd-4851-8728-2f3ba1520613_fuels-dens_2100_000.png
12,225,0.05,0,1,121247,50131,171378,images/run_42ce04f7-04d7-4abb-9c53-abad736485b4_fuels-dens_2100_000.png
12,225,0.05,1,1,135343,52022,187365,images/run_e8a9db20-e73e-4755-9643-bcfb1e450f95_fuels-dens_2100_000.png
8,180,0.05,1,1,135411,47820,183231,images/run_ff8ed838-9173-4660-b194-302b52019223_fuels-dens_2100_000.png
5,240,0.05,0,1,135422,45932,181354,images/run_a5ca3f93-afa3-4455-b2b8-8359b0daed5b_fuels-dens_2100_000.png
5,240,0.05,1,1,135422,48699,184121,images/run_875431e2-e622-4e4f-8dbe-07e457459387_fuels-dens_2100_000.png
5,240,0.05,0,1,120834,32339,153173,images/run_66b2c158-d090-4932-a2d9-661815b4d277_fuels-dens_2100_000.png
2,255,0.05,0,1,135423,11414,146837,images/run_a5574e60-6e1e-4d42-9d30-50c6a9c3c8a4_fuels-dens_2100_000.png
3,240,0.05,0,1,135427,34201,169628,images/run_40869bfd-14d5-47f7-8bc0-f47e4d390c68_fuels-dens_2100_000.png
3,240,0.05,0,1,135427,14832,150259,images/run_e48ebc64-083c-42d0-8244-d3925b7d3f55_fuels-dens_2100_000.png
2,225,0.05,0,1,135427,19867,155294,images/run_e25026d7-bec6-4f48-a71f-5938934fb00a_fuels-dens_2100_000.png
5,225,0.05,0,1,135393,45643,181036,images/run_7bfabe78-5fd5-4e7c-b7ea-71a0c4460ab5_fuels-dens_2100_000.png
5,225,0.05,1,1,135400,51648,187048,images/run_80ec6862-6a40-4142-a273-5a9a2ac686dd_fuels-dens_2100_000.png
5,225,0.05,0,1,121037,34304,155341,images/run_bdd59d1d-322f-42ed-9a7b-c0438840aad8_fuels-dens_2100_000.png
2,225,0.05,0,1,120143,3376,123519,images/run_004e4371-f3a9-42a3-9b0a-72299972116e_fuels-dens_2100_000.png
2,225,0.05,0,0,135427,14547,149974,images/run_168cb554-21b6-4179-895a-85a6d0caaa41_fuels-dens_2100_000.png
12,225,0.05,1,1,135337,51469,186806,images/run_195859a2-149a-4ea0-858b-94d8d5d7303b_fuels-dens_2100_000.png
2,240,0.05,0,1,119847,1137,120984,images/run_80033c9c-cd1d-4853-b3ce-d0017b3db7c6_fuels-dens_2100_000.png
8,195,0.05,1,1,120964,47536,168500,images/run_f238c486-077b-44ad-b0bd-b4fdd7cf146e_fuels-dens_2100_000.png
2,255,0.05,0,1,135425,14551,149976,images/run_9921a0f5-a927-4d6c-92a6-3a102bb2e3c7_fuels-dens_2100_000.png
2,255,0.05,0,1,119645,0,119645,images/run_5c1a63e4-3de4-4fbf-a52f-57748621218d_fuels-dens_2100_000.png
8,255,0.05,1,1,135417,48762,184179,images/run_428afd3f-d393-4748-a6ec-a212750d8271_fuels-dens_2100_000.png
8,255,0.05,1,1,135420,47392,182812,images/run_49e61f17-aec7-4da2-8f20-63df1391373c_fuels-dens_2100_000.png
8,240,0.05,1,1,135410,48181,183591,images/run_7d39ffec-6e70-4cd4-b250-34c314878685_fuels-dens_2100_000.png
8,240,0.05,1,1,135387,48859,184246,images/run_780c3399-87ad-4945-a1be-ccfe18bbc11d_fuels-dens_2100_000.png
8,240,0.05,1,1,121134,48360,169494,images/run_4f45f27f-1712-4c80-875c-f51949021047_fuels-dens_2100_000.png
3,180,0.05,0,1,121086,8185,129271,images/run_93d9ded8-0360-4e71-b288-3a62d85be3e6_fuels-dens_2100_000.png
3,180,0.05,0,1,135427,23541,158968,images/run_e28c8469-bd15-43ed-aa81-db7f8e85e0bd_fuels-dens_2100_000.png
3,180,0.05,0,1,135420,17982,153402,images/run_fd0dfd15-6abf-4ab1-a266-7f6b3068cc5c_fuels-dens_2100_000.png
2,240,0.05,0,1,135427,19161,154588,images/run_01176c66-ae94-4a5d-bc74-312a008a3491_fuels-dens_2100_000.png
8,225,0.05,1,1,135401,49711,185112,images/run_9098a521-3274-480f-a92f-715027a40d4c_fuels-dens_2100_000.png
8,225,0.05,1,1,121254,47852,169106,images/run_51909ccd-425c-4f7a-8cb8-b2917ec08f77_fuels-dens_2100_000.png
12,180,0.05,1,1,121039,48626,169665,images/run_b37fd7f8-f500-4515-beb5-de7292ec27b3_fuels-dens_2100_000.png
3,225,0.05,0,1,135424,35331,170755,images/run_20dfbd26-7d83-496a-93fa-dc1731308278_fuels-dens_2100_000.png
12,180,0.05,1,1,135400,51250,186650,images/run_bd66fd42-becc-4fb2-a51d-ec3bf0fe0264_fuels-dens_2100_000.png
12,180,0.05,1,1,135394,49431,184825,images/run_8e7e2a57-1c48-40e0-a621-e160450d736e_fuels-dens_2100_000.png
2,240,0.05,0,1,135426,9753,145179,images/run_be3faeff-2a9f-40f2-8c28-a51e8a7cc125_fuels-dens_2100_000.png
8,195,0.05,1,1,135405,49242,184647,images/run_931691c5-01cd-441e-adb2-fbf62fd78d38_fuels-dens_2100_000.png
8,195,0.05,1,1,135363,52136,187499,images/run_c1144aa8-57e7-416d-9b3e-791d5edfe964_fuels-dens_2100_000.png
3,195,0.05,0,1,120772,8314,129086,images/run_7593c4b8-83fe-4ec5-bb51-74792086a383_fuels-dens_2100_000.png
3,195,0.05,0,1,135427,33244,168671,images/run_08248509-9d32-4d58-9bca-58abc841daf5_fuels-dens_2100_000.png
8,225,0.05,1,1,135420,52010,187430,images/run_6b3c0fda-ba74-4f28-b298-f349e442a074_fuels-dens_2100_000.png
5,195,0.05,1,1,135403,44648,180051,images/run_bcce4b2d-1b0d-414f-a49f-dff9291090ef_fuels-dens_2100_000.png
8,255,0.05,1,1,120976,46211,167187,images/run_8ad4b06b-d192-421a-9acc-ed278ad5ab26_fuels-dens_2100_000.png
3,255,0.05,0,1,135427,25257,160684,images/run_5aaf4e36-74fc-4f27-a681-09e83d5e9a4e_fuels-dens_2100_000.png
5,195,0.05,0,1,135426,45020,180446,images/run_ee3f2f19-66a3-4ad9-9f54-e0f913ac396d_fuels-dens_2100_000.png
2,195,0.05,0,1,120768,5065,125833,images/run_ce1a4937-52c8-45a7-9662-96f13e5143a6_fuels-dens_2100_000.png
5,180,0.05,0,1,121265,20430,141695,images/run_22513dca-9887-490c-9e04-0ef0bc8cf96e_fuels-dens_2100_000.png
5,180,0.05,0,1,135426,44510,179936,images/run_18436fd6-f070-47a7-8bda-b18a614773c7_fuels-dens_2100_000.png
5,195,0.05,1,1,135426,50942,186368,images/run_d576304c-1eaa-47ff-bc7f-77471acd9a59_fuels-dens_2100_000.png
5,180,0.05,0,1,135426,29473,164899,images/run_05cd5769-48d4-45a2-912b-97e2bcf1b239_fuels-dens_2100_000.png
5,195,0.05,0,1,120876,23827,144703,images/run_7c118ff0-0a8d-48de-b319-2dbbb801808f_fuels-dens_2100_000.png
2,195,0.05,0,1,135427,12446,147873,images/run_db34d9b0-0788-4197-8694-66e324490e70_fuels-dens_2100_000.png
3,240,0.05,0,1,135415,31099,166514,images/run_4a180ac2-f91a-4fc6-a8c2-b4d529dcf921_fuels-dens_2100_000.png
3,240,0.05,0,1,135418,13353,148771,images/run_39afc5bb-2dcd-49ca-9c6a-c50a6f0c6e5a_fuels-dens_2100_000.png
3,255,0.05,0,1,119641,1667,121308,images/run_9af918a3-e414-47eb-9f1b-4784be48fa34_fuels-dens_2100_000.png
3,255,0.05,0,1,135417,28986,164403,images/run_f6f9eb4d-8729-4281-b561-69a830601ce3_fuels-dens_2100_000.png
3,255,0.05,0,1,119911,1830,121741,images/run_7480314b-11c0-4739-b328-62b1328b7772_fuels-dens_2100_000.png
12,255,0.05,1,1,121217,48382,169599,images/run_31b3e697-4f33-421c-9968-d51b84c727b4_fuels-dens_2100_000.png
12,255,0.05,1,1,135397,35665,171062,images/run_9dcd7677-3740-436e-8891-8a6f815b9bca_fuels-dens_2100_000.png
12,255,0.05,1,1,135354,48168,183522,images/run_9866b1d7-c21f-4a1f-a4d7-635cf51d9b22_fuels-dens_2100_000.png
3,255,0.05,0,1,135420,15568,150988,images/run_da7e06ba-4f3e-49a8-8afa-6a9f197d3091_fuels-dens_2100_000.png
5,180,0.05,0,1,121225,18028,139253,images/run_934d4c0d-2a82-42fb-940f-c7a47ec904b7_fuels-dens_2100_000.png
2,195,0.05,0,1,135427,16983,152410,images/run_b805b741-51b7-4934-bb5e-caedc949a378_fuels-dens_2100_000.png
2,180,0.05,0,1,135425,10226,145651,images/run_0e69ec6b-aaed-4876-a9a6-6c5ea1d16a2a_fuels-dens_2100_000.png
12,240,0.05,1,1,121269,48562,169831,images/run_63c9feb1-783e-4281-b89e-c73d8cbd07ed_fuels-dens_2100_000.png
12,240,0.05,1,1,135377,51701,187078,images/run_671aa2e2-5a18-419e-a1b6-01216771c5bb_fuels-dens_2100_000.png
5,180,0.05,1,1,135422,45433,180855,images/run_815af0e9-f874-4ef8-9adc-cd69615a129e_fuels-dens_2100_000.png
12,240,0.05,1,1,135349,48555,183904,images/run_82b682a8-683d-4205-8195-3f6437e520b1_fuels-dens_2100_000.png
5,255,0.05,0,1,120667,15711,136378,images/run_1d4f4e0d-d24e-4cf4-8458-133b0f722021_fuels-dens_2100_000.png
5,195,0.05,0,1,120697,28949,149646,images/run_78bd1025-d389-4544-b498-2b177dbba260_fuels-dens_2100_000.png
5,195,0.05,1,1,135398,51252,186650,images/run_035cd435-efac-4fd3-b1c9-132aef242594_fuels-dens_2100_000.png
3,240,0.05,0,1,120049,2269,122318,images/run_2c3dcce5-499e-4f3d-bd4b-9640e4e4d24e_fuels-dens_2100_000.png
3,225,0.05,0,1,135411,22197,157608,images/run_c0dafa01-dd59-4c90-be67-7fa033342665_fuels-dens_2100_000.png
2,180,0.05,0,1,135427,15736,151163,images/run_58cc9e64-469f-481d-86f9-622fbf9555a2_fuels-dens_2100_000.png
5,180,0.05,0,1,135397,38097,173494,images/run_a8c27ccf-a87e-404d-b12c-d8d6d87dbdf9_fuels-dens_2100_000.png
3,255,0.05,0,1,135427,10000,145427,images/run_92dc7f60-2cc3-42eb-b22e-a82af6a9605c_fuels-dens_2100_000.png
5,240,0.1,1,1,135408,48405,183813,images/run_075c83f7-2525-4417-acfc-447e0a5c1800_fuels-dens_2100_000.png
12,255,0.1,1,1,135103,44814,179917,images/run_62e64467-a020-41f6-87c8-6d4e7653790f_fuels-dens_2100_000.png
3,180,0.1,0,1,135370,11020,146390,images/run_1e1b35f0-3f5d-444b-b5a5-2f3876885a1b_fuels-dens_2100_000.png
8,180,0.1,0,1,119579,18988,138567,images/run_b624475a-caca-43ad-bba1-6d2a3d8aabe3_fuels-dens_2100_000.png
8,180,0.1,1,1,135272,50576,185848,images/run_27176cfa-a66a-4167-bfba-4816285e1faa_fuels-dens_2100_000.png
8,180,0.1,0,1,135357,43546,178903,images/run_9c494f8c-ee74-4a7a-88c5-6df828bc0961_fuels-dens_2100_000.png
5,240,0.1,0,1,135392,34299,169691,images/run_137d3b76-b72e-4bb8-98d7-c9965b537f2c_fuels-dens_2100_000.png
8,255,0.1,1,1,120176,33677,153853,images/run_b47fe6aa-345f-4b51-8522-69290b6058bc_fuels-dens_2100_000.png
8,255,0.1,1,1,135230,45677,180907,images/run_3fc4d186-a12a-4cb8-ac99-c6bf13b8feca_fuels-dens_2100_000.png
3,195,0.1,0,1,135417,27680,163097,images/run_e2284392-04c8-47e2-9a11-83cc4daa0af2_fuels-dens_2100_000.png
3,195,0.1,0,1,118914,6199,125113,images/run_9e11fa6b-89ad-4890-9dfe-15892ddce39c_fuels-dens_2100_000.png
5,255,0.1,0,1,119726,8697,128423,images/run_aa514541-dc71-44b9-80b7-6dcfb9c26062_fuels-dens_2100_000.png
5,240,0.1,0,1,119932,23230,143162,images/run_4063734f-1dde-4c36-85a1-5370780754be_fuels-dens_2100_000.png
5,255,0.1,0,1,135380,36124,171504,images/run_ed74193f-0627-4cc7-87a7-67dcfc99ec72_fuels-dens_2100_000.png
8,255,0.1,1,1,135319,42315,177634,images/run_31ef8d4e-0dec-431a-a21e-c7e321b548fe_fuels-dens_2100_000.png
5,255,0.1,0,1,135391,34454,169845,images/run_e029ec45-7776-4f73-b7a5-9e2bd250867c_fuels-dens_2100_000.png
3,195,0.1,0,1,135373,16183,151556,images/run_47ae71ae-ddd8-4b3a-b6f4-aa4c189296b1_fuels-dens_2100_000.png
12,255,0.1,1,1,135216,37589,172805,images/run_3a5b2e04-cb37-45a8-89a7-c506f4018f20_fuels-dens_2100_000.png
12,255,0.1,1,1,120014,47583,167597,images/run_2f845c08-d2b6-4ed5-90a3-a2bced7c46f7_fuels-dens_2100_000.png
3,255,0.1,0,1,135332,7844,143176,images/run_6b20d72c-f849-4d71-a6b2-3ee3ffed1ceb_fuels-dens_2100_000.png
12,225,0.1,1,1,134655,50164,184819,images/run_fd409b3e-883e-4058-9d79-fbaaea2566a8_fuels-dens_2100_000.png
12,225,0.1,1,1,135086,51787,186873,images/run_adced607-78cc-47ef-b95d-11bb7cecf5e5_fuels-dens_2100_000.png
12,225,0.1,1,1,120183,49997,170180,images/run_654e512b-3077-40a1-9c54-14aa6598d6b6_fuels-dens_2100_000.png
3,255,0.1,0,1,135409,13368,148777,images/run_d1d5c1e3-444f-4450-a0cb-e5be0cea0b58_fuels-dens_2100_000.png
3,255,0.1,0,1,118651,954,119605,images/run_f8a8a511-ec2c-4ec8-bf53-a4a608ebcc61_fuels-dens_2100_000.png
5,180,0.1,0,1,119262,12762,132024,images/run_dc9e0ce4-7080-4808-a962-df35709ff42d_fuels-dens_2100_000.png
3,240,0.1,0,1,135405,11506,146911,images/run_d7be397f-0ca9-40e4-9408-768948f09f95_fuels-dens_2100_000.png
12,240,0.1,1,1,120220,48141,168361,images/run_4c94e166-6881-455c-b3af-f99c4ce18bab_fuels-dens_2100_000.png
5,180,0.1,0,1,135391,36403,171794,images/run_de2641c3-c838-45b2-a240-dd52768a81f3_fuels-dens_2100_000.png
12,240,0.1,1,1,135187,51239,186426,images/run_bfd62b03-95bd-4bf8-bb38-6f027d02912b_fuels-dens_2100_000.png
5,180,0.1,0,1,135381,21364,156745,images/run_63adc5ba-1136-46a0-9713-5786c9613dcc_fuels-dens_2100_000.png
3,240,0.1,0,1,135409,22195,157604,images/run_af26879d-25ff-419e-8ad9-4463bcf0e47a_fuels-dens_2100_000.png
5,195,0.1,0,1,119314,20897,140211,images/run_235c1a2d-c8c8-42eb-ab93-c6419ca767cb_fuels-dens_2100_000.png
3,240,0.1,0,0,118926,1118,120044,images/run_cf6aa4ab-5ebc-4c66-86c4-dd3240563e9d_fuels-dens_2100_000.png
5,195,0.1,1,1,135371,48951,184322,images/run_0c865be7-1920-43f4-b260-d3619119b563_fuels-dens_2100_000.png
12,195,0.1,1,1,135009,48788,183797,images/run_cf9323b3-0091-4a19-91ce-5609e3bcd0fe_fuels-dens_2100_000.png
12,195,0.1,1,1,134819,51902,186721,images/run_372ec535-eaff-4844-b147-130e28853eef_fuels-dens_2100_000.png
12,195,0.1,1,1,119648,49905,169553,images/run_980c22a9-c379-4731-9601-9fcae332e1db_fuels-dens_2100_000.png
5,195,0.1,0,1,135417,35724,171141,images/run_a699e558-deec-4be5-9a7b-b6b65ef5285e_fuels-dens_2100_000.png
12,240,0.1,1,1,134806,48355,183161,images/run_e6c6ad9d-3873-4080-a261-2f66fdf842e6_fuels-dens_2100_000.png
3,225,0.1,0,1,135402,12535,147937,images/run_486c1d87-ec2d-4213-9eb5-9d6f489a71f6_fuels-dens_2100_000.png
5,225,0.1,0,1,119897,30194,150091,images/run_c7e07cd4-0bda-4022-b061-cb049028e8c2_fuels-dens_2100_000.png
5,225,0.1,1,1,135400,48606,184006,images/run_727d91b9-fedb-42fc-ab4d-371b27250815_fuels-dens_2100_000.png
12,180,0.1,0,1,134983,46269,181252,images/run_6587c6bf-8e64-4395-a3fd-a920ada3b069_fuels-dens_2100_000.png
3,225,0.1,0,1,135418,28439,163857,images/run_147bede6-5ed7-4b7f-bf9f-4ae86b413b80_fuels-dens_2100_000.png
3,225,0.1,0,0,118949,4669,123618,images/run_621f4f7b-c9db-49f5-b687-5203f253699c_fuels-dens_2100_000.png
12,180,0.1,0,1,118959,44203,163162,images/run_1c000f32-6399-47e6-980d-45b13afaf0c2_fuels-dens_2100_000.png
8,255,0.1,1,1,135380,43813,179193,images/run_ee080362-53b4-44c3-92a5-e3ce2f8beec1_fuels-dens_2100_000.png
8,195,0.1,1,1,119781,42886,162667,images/run_bc2b5fd4-eada-4336-8e6a-a9bb257da154_fuels-dens_2100_000.png
2,225,0.1,0,0,118599,626,119225,images/run_9b91d9bd-909a-45aa-8f65-dbfc8953572e_fuels-dens_2100_000.png
5,180,0.1,0,1,135231,35892,171123,images/run_53d42a39-7546-460e-9b37-6cbd9e9675fc_fuels-dens_2100_000.png
2,195,0.1,0,1,135384,13040,148424,images/run_80ada8f9-18b8-47c4-bc0d-3b189cfa27b0_fuels-dens_2100_000.png
2,195,0.1,0,0,118789,1363,120152,images/run_a91c3dce-bb7b-4d41-bc21-679d9d73061c_fuels-dens_2100_000.png
5,180,0.1,0,1,135292,23773,159065,images/run_0382e4b2-a202-466f-ad45-9b9012267422_fuels-dens_2100_000.png
2,180,0.1,0,0,135207,7214,142421,images/run_3ca3af2f-227b-401a-8911-e550b99e2f35_fuels-dens_2100_000.png
2,180,0.1,0,0,119249,1180,120429,images/run_d78b5208-b0ed-4f1c-abfb-6142ce45c631_fuels-dens_2100_000.png
5,195,0.1,0,1,119375,18336,137711,images/run_b8ab6fda-a77e-4b4b-8a7f-0c77a88921aa_fuels-dens_2100_000.png
5,195,0.1,0,1,135350,46626,181976,images/run_0aafb908-5ccb-4f32-930a-8b6ed274a104_fuels-dens_2100_000.png
5,195,0.1,0,1,135186,28776,163962,images/run_ad56093a-1b10-499d-9ec0-ca595dddcd2c_fuels-dens_2100_000.png
12,255,0.1,1,1,119811,47115,166926,images/run_80df3c18-cc09-4866-89fe-4a1bdde3bc80_fuels-dens_2100_000.png
12,195,0.1,1,1,135217,51508,186725,images/run_e0cd0ef4-b65f-43ba-85d2-8e8f987e1ce3_fuels-dens_2100_000.png
5,225,0.1,0,1,119914,28684,148598,images/run_e22c3c85-9050-48d7-b245-76510870d9aa_fuels-dens_2100_000.png
2,225,0.1,0,1,135413,10965,146378,images/run_f3a77e00-5691-43cb-be6e-e291fb2bb028_fuels-dens_2100_000.png
5,225,0.1,1,1,135361,50387,185748,images/run_92169266-412f-4dde-af88-afa4892eb910_fuels-dens_2100_000.png
2,225,0.1,0,1,134399,7251,141650,images/run_c142bfbb-f937-4800-96f3-8dd8dbedd57b_fuels-dens_2100_000.png
2,240,0.1,0,0,118468,639,119107,images/run_7f3fd02b-a2c1-4a4a-8199-fe414be5b71e_fuels-dens_2100_000.png
3,195,0.1,0,1,135382,28734,164116,images/run_1dbcd6a9-2d6b-4113-88f9-f024382d05ae_fuels-dens_2100_000.png
3,225,0.1,0,0,118878,3780,122658,images/run_155d0e55-bb87-4a13-acf7-5082865b208e_fuels-dens_2100_000.png
3,225,0.1,0,1,135289,31066,166355,images/run_a4006216-5ef5-49af-947d-eeee00d48d27_fuels-dens_2100_000.png
3,195,0.1,0,0,118960,7377,126337,images/run_d245b3f4-fc05-4f34-925b-52d9b3c47aaa_fuels-dens_2100_000.png
3,180,0.1,0,0,135251,10399,145650,images/run_14878592-2c90-45c0-9947-765dd89ba2b8_fuels-dens_2100_000.png
3,180,0.1,0,1,135310,16214,151524,images/run_b33a5972-41f0-4a3b-9bc2-dab82c0947aa_fuels-dens_2100_000.png
3,180,0.1,0,0,119475,3921,123396,images/run_2b27869b-3a75-416e-b87e-8aa38649f3f8_fuels-dens_2100_000.png
3,240,0.1,0,0,118787,1533,120320,images/run_7d5e5f29-91dc-4925-a3a4-a2ef29eae993_fuels-dens_2100_000.png
3,240,0.1,0,1,135366,24997,160363,images/run_9f910bf2-6d1f-4daa-949f-3291fd63261f_fuels-dens_2100_000.png
2,255,0.1,0,0,134726,5362,140088,images/run_7e409cd0-d5b7-4459-a007-24525a78a05e_fuels-dens_2100_000.png
2,255,0.1,0,0,118299,0,118299,images/run_156b0bf1-34d9-41bc-989f-c6287622316f_fuels-dens_2100_000.png
2,240,0.1,1,0,134970,6669,141639,images/run_71a9277d-dd21-4957-b257-6f6048a73a64_fuels-dens_2100_000.png
2,240,0.1,0,1,135351,13834,149185,images/run_fb8a60bc-ddfc-4906-869c-a2745bfc3456_fuels-dens_2100_000.png
3,255,0.1,0,0,118625,820,119445,images/run_63b9e67e-6e32-4ea1-9f94-903115bac4ee_fuels-dens_2100_000.png
3,255,0.1,0,1,135370,19701,155071,images/run_946340af-38ab-4afb-9d13-6e160d3d68be_fuels-dens_2100_000.png
8,240,0.1,1,1,134943,47277,182220,images/run_bdc0d6aa-3a98-450e-99dc-c701d1436cd5_fuels-dens_2100_000.png
5,225,0.1,1,1,134994,36341,171335,images/run_89ac1664-26b2-425e-838b-2e149a2ff756_fuels-dens_2100_000.png
12,255,0.1,1,1,135198,33395,168593,images/run_a1bd6b10-a166-448d-96d8-fac3ce78e03c_fuels-dens_2100_000.png
8,195,0.1,1,1,134967,51272,186239,images/run_b5eb3156-23a5-4c07-a5da-d7257a31a368_fuels-dens_2100_000.png
8,195,0.1,1,1,134656,48359,183015,images/run_8f097c76-3dd0-4ca7-95df-a05c721605b2_fuels-dens_2100_000.png
8,255,0.1,1,1,135235,45054,180289,images/run_530b9a77-eca4-45ea-908e-1f5ccd52502e_fuels-dens_2100_000.png
8,255,0.1,1,1,120085,34320,154405,images/run_b9dcb37b-4012-4e4a-879b-a77f450095d1_fuels-dens_2100_000.png
8,225,0.1,1,1,120431,47148,167579,images/run_00f19e8d-c8b8-4033-a6fe-e0709b165708_fuels-dens_2100_000.png
8,240,0.1,1,1,135194,47339,182533,images/run_07404bb8-d3a9-4823-847a-35e911ef5085_fuels-dens_2100_000.png
8,240,0.1,1,1,135309,49759,185068,images/run_40c2a9eb-5e09-41b8-ac98-61a3acd69896_fuels-dens_2100_000.png
8,240,0.1,1,1,120081,46660,166741,images/run_4d457d46-7dc5-4ca0-aeb0-47b7b2f5d756_fuels-dens_2100_000.png
8,225,0.1,1,1,135254,51850,187104,images/run_9e7a146a-59e7-4069-92ad-efea57dfd776_fuels-dens_2100_000.png
8,225,0.1,1,1,134731,47527,182258,images/run_3f480ea2-c5a0-443d-8409-d53cd59ef60b_fuels-dens_2100_000.png
8,225,0.1,1,1,135317,47925,183242,images/run_91f73679-4cd9-45ef-a3f0-6c88294239bd_fuels-dens_2100_000.png
8,225,0.1,1,1,135327,51369,186696,images/run_d2b1d8db-2163-4bf7-843d-2447e2b6a768_fuels-dens_2100_000.png
8,225,0.1,1,1,119987,45989,165976,images/run_7651ddec-c342-4add-883a-c1b4b2742b74_fuels-dens_2100_000.png
8,240,0.1,1,1,120208,47020,167228,images/run_47d383ed-9dc7-44cc-bf01-5c183b01670c_fuels-dens_2100_000.png
8,240,0.1,1,1,135317,50154,185471,images/run_4932a718-029b-466d-a51e-82734cffb4de_fuels-dens_2100_000.png
8,195,0.1,1,1,135328,48507,183835,images/run_5c4c8dda-158d-4786-97cf-99d5c4584284_fuels-dens_2100_000.png
8,195,0.1,1,1,135347,51198,186545,images/run_c80280b9-0fdb-492a-825f-a2232803c75f_fuels-dens_2100_000.png
8,195,0.1,1,1,119848,47228,167076,images/run_e19b8a30-f627-4be3-afde-520ece1169ed_fuels-dens_2100_000.png
12,255,0.1,1,1,135192,46895,182087,images/run_27a0f6c1-89e6-41e7-a897-790754621912_fuels-dens_2100_000.png
12,180,0.1,0,1,119078,43998,163076,images/run_22c0a0a0-de28-4094-85d6-f0bfe2a52883_fuels-dens_2100_000.png
12,180,0.1,1,1,135325,47203,182528,images/run_4b2f0427-d1be-4ad2-989e-8d9a2ab594be_fuels-dens_2100_000.png
5,240,0.1,0,1,119824,18815,138639,images/run_f98818eb-e0e1-40c6-b65d-4f9845981b4b_fuels-dens_2100_000.png
5,240,0.1,1,1,135363,48103,183466,images/run_110e7d53-5054-4efc-bf3d-026975b71f7c_fuels-dens_2100_000.png
5,240,0.1,1,1,135092,34204,169296,images/run_3aebc055-f2aa-491f-83b2-6f5fe3d9828a_fuels-dens_2100_000.png
12,240,0.1,1,1,135103,48369,183472,images/run_1076ac76-bc3e-4550-8bb0-974a1e4633f3_fuels-dens_2100_000.png
12,240,0.1,1,1,135291,50757,186048,images/run_97dda619-f4b7-4071-9040-225bb589f587_fuels-dens_2100_000.png
12,240,0.1,1,1,119817,48390,168207,images/run_9109efad-db24-4211-92bf-43eb68be35ef_fuels-dens_2100_000.png
5,255,0.1,1,0,119787,8017,127804,images/run_59201825-8c53-4790-ae1f-2cd57db706b4_fuels-dens_2100_000.png
12,225,0.1,1,1,135076,48490,183566,images/run_c4b0ba1a-ba29-48ff-87f2-a9df253867f0_fuels-dens_2100_000.png
12,225,0.1,1,1,135157,51701,186858,images/run_673cfb19-301a-4600-9737-f0574f91c8be_fuels-dens_2100_000.png
5,255,0.1,1,1,135319,43667,178986,images/run_edd087ee-725b-4505-a3b0-6d8f13dff91a_fuels-dens_2100_000.png
12,225,0.1,1,1,119797,48370,168167,images/run_028873b3-aa6b-4a4f-947a-c90e032a3925_fuels-dens_2100_000.png
8,180,0.1,0,1,119721,31868,151589,images/run_55b929e4-89d1-4a08-8708-3133fa7143c1_fuels-dens_2100_000.png
8,180,0.1,1,1,135002,46367,181369,images/run_414b89c4-7d4a-44b7-bdd5-b2edd019fc2f_fuels-dens_2100_000.png
12,195,0.1,1,1,135148,49032,184180,images/run_be433426-7628-4ca5-aa65-fadbd3d4ff96_fuels-dens_2100_000.png
12,195,0.1,1,1,119773,48868,168641,images/run_7b776d41-d4e1-430c-bb67-e7b4348d2446_fuels-dens_2100_000.png
8,180,0.1,0,1,135166,43085,178251,images/run_df07cdef-fb9e-40cc-8714-a4ea067ea9c3_fuels-dens_2100_000.png
12,180,0.1,1,1,135283,47633,182916,images/run_1381ca39-d8a0-40aa-8b77-8c9adc55085f_fuels-dens_2100_000.png
12,180,0.1,1,1,135079,48104,183183,images/run_9866714a-c501-45c8-ba87-f076794ebfa3_fuels-dens_2100_000.png
12,195,0.1,1,1,119767,49223,168990,images/run_92785624-80eb-4525-99c8-cfdd242478d7_fuels-dens_2100_000.png
12,225,0.1,1,1,120247,47363,167610,images/run_025988c7-d019-4016-8a19-08e8c9c4257f_fuels-dens_2100_000.png
8,195,0.1,1,1,120058,42469,162527,images/run_b46f4524-f7e1-4abd-814d-5a645247ef3d_fuels-dens_2100_000.png
8,195,0.1,1,1,135413,51018,186431,images/run_df506c97-3b6b-42ba-a26c-e4499b408c77_fuels-dens_2100_000.png
2,180,0.1,0,0,135296,7662,142958,images/run_6f04d8f5-bdcd-4a63-96fd-0d0e7badd709_fuels-dens_2100_000.png
8,195,0.1,1,1,135419,48450,183869,images/run_fc3163bc-4d62-43c1-a4d1-bc7f48f62ba5_fuels-dens_2100_000.png
5,240,0.1,1,0,119856,16615,136471,images/run_e79dbbd1-da18-4516-b687-a7293dd4ce86_fuels-dens_2100_000.png
3,180,0.1,0,0,135385,9988,145373,images/run_199a8c35-c3f8-4de1-be7d-150c46b2a536_fuels-dens_2100_000.png
3,225,0.1,0,0,118901,2882,121783,images/run_87edb983-ed6d-4553-8ac1-a31a0fbf6d64_fuels-dens_2100_000.png
8,225,0.1,1,1,120492,47759,168251,images/run_e9051709-c722-4799-a426-5c9857c5092c_fuels-dens_2100_000.png
5,225,0.1,0,1,135422,29334,164756,images/run_e5584b0e-ffff-4981-8e95-f23e83dca8c8_fuels-dens_2100_000.png
2,195,0.1,0,0,118883,1437,120320,images/run_b44e4fd5-042e-4467-abe6-8866607a876b_fuels-dens_2100_000.png
2,195,0.1,1,0,135400,11645,147045,images/run_f10a667b-79f3-4347-a52a-e6c24804fb87_fuels-dens_2100_000.png
2,195,0.1,0,0,135328,7579,142907,images/run_4cbf14d2-b769-4c0c-8e45-400475d49c65_fuels-dens_2100_000.png
5,225,0.1,1,1,135425,49213,184638,images/run_80f60eb4-28c4-49d6-872a-eae15185ab70_fuels-dens_2100_000.png
5,225,0.1,1,1,119730,29910,149640,images/run_0d7480ee-d2a0-4529-b468-2fbefa28267f_fuels-dens_2100_000.png
12,195,0.1,1,1,135355,48646,184001,images/run_62a4756d-1132-447d-930b-eb7a5532fbfb_fuels-dens_2100_000.png
12,195,0.1,1,1,135388,51501,186889,images/run_dadfe442-2a28-4396-852b-b81cd19d94ef_fuels-dens_2100_000.png
12,240,0.1,1,1,120319,47946,168265,images/run_a8a58624-64a9-4bc0-8695-1b6906728497_fuels-dens_2100_000.png
8,225,0.1,1,1,135410,51745,187155,images/run_9cd6eda1-5e4b-4db1-a359-e588879c88a2_fuels-dens_2100_000.png
8,225,0.1,1,1,135410,47507,182917,images/run_a520752a-8077-4f44-8730-998a076ec471_fuels-dens_2100_000.png
2,195,0.1,0,0,135371,8201,143572,images/run_20322f23-c388-4105-9ad8-474b5e244a56_fuels-dens_2100_000.png
2,225,0.1,0,0,118351,1609,119960,images/run_41ad0b5e-f4bf-4e06-ba88-7326a15a20d9_fuels-dens_2100_000.png
5,240,0.1,1,1,135424,47489,182913,images/run_932d1aaf-c240-4ce8-8311-cf3d9a38ae6e_fuels-dens_2100_000.png
2,225,0.1,0,0,135418,13062,148480,images/run_f923862d-36d6-4764-87e7-f07a0143b2e2_fuels-dens_2100_000.png
2,225,0.1,0,0,118565,0,118565,images/run_a5932f18-d2fb-4320-9447-d7d3068cc2c6_fuels-dens_2100_000.png
2,180,0.1,0,0,118757,1331,120088,images/run_65e883c4-79e1-4de4-8863-10c05e95628f_fuels-dens_2100_000.png
12,240,0.1,1,1,135351,49819,185170,images/run_8eef95db-e50e-4521-826a-7f9f9c9df122_fuels-dens_2100_000.png
8,180,0.1,1,1,135387,45577,180964,images/run_ac187245-153d-40fd-a2d1-3e67cc74480a_fuels-dens_2100_000.png
3,195,0.1,0,0,119029,4468,123497,images/run_7d32ec66-002f-4fda-b8d2-3e782f24ac0a_fuels-dens_2100_000.png
8,180,0.1,0,1,119813,23305,143118,images/run_c7d0f50d-6516-4064-81c8-dbde16c75ce6_fuels-dens_2100_000.png
3,180,0.1,0,0,119169,6329,125498,images/run_8354fd07-1aba-4cf0-b39e-6a1d0f3e2eb2_fuels-dens_2100_000.png
12,240,0.1,1,1,135324,48056,183380,images/run_7a31d74f-efd8-4984-846e-6fd57549891f_fuels-dens_2100_000.png
2,240,0.1,0,0,118410,599,119009,images/run_59c929f2-9305-4839-9971-85b73d684591_fuels-dens_2100_000.png
5,255,0.1,1,1,135425,24504,159929,images/run_d83c19d1-2a65-4fb4-907e-219cce7a617c_fuels-dens_2100_000.png
2,225,0.1,0,0,135400,8319,143719,images/run_76c7dc20-e7e7-4e18-b7a5-1c2a90b63f27_fuels-dens_2100_000.png
5,255,0.1,1,1,135422,41515,176937,images/run_45ea02f4-4fe2-4f59-bbf2-5b6dbe2d1c0b_fuels-dens_2100_000.png
5,255,0.1,1,0,119759,5241,125000,images/run_980697a0-a3b4-40b5-9451-33c722dc5b69_fuels-dens_2100_000.png
3,195,0.1,0,1,135419,29481,164900,images/run_1c38c125-a753-4147-9844-b91f6986ba24_fuels-dens_2100_000.png
12,255,0.1,1,1,120146,47527,167673,images/run_fa25a739-0508-4553-916f-6f0fada1a7e1_fuels-dens_2100_000.png
12,255,0.1,1,1,135383,44704,180087,images/run_a8205410-a279-4b6c-8d96-66c88d25b09a_fuels-dens_2100_000.png
12,255,0.1,1,1,135360,45697,181057,images/run_febdb192-930e-4fc1-9e70-83007aa47425_fuels-dens_2100_000.png
3,195,0.1,0,0,135416,12021,147437,images/run_7c457822-a68d-43a6-a6b5-526ccb04833f_fuels-dens_2100_000.png
12,225,0.1,0,1,135391,48423,183814,images/run_f6c3f1f8-47fc-4f5a-9b7c-ba140ce753ad_fuels-dens_2100_000.png
12,225,0.1,1,1,135348,51539,186887,images/run_b9b3a6ca-f025-4070-93ae-e582a87ecfc8_fuels-dens_2100_000.png
2,255,0.1,0,0,135292,5647,140939,images/run_59cb02f9-fff0-42bd-9631-4faa9e80582d_fuels-dens_2100_000.png
2,240,0.1,0,0,135426,9626,145052,images/run_dedc91cf-d888-4e14-9137-3cc0f8b98de3_fuels-dens_2100_000.png
2,240,0.1,0,0,135345,7981,143326,images/run_dcb85f6c-9405-4e48-96a9-d77f17363b6c_fuels-dens_2100_000.png
2,225,0.1,0,0,135426,12354,147780,images/run_89dba2c7-50cc-4197-bd20-a8c4494ab249_fuels-dens_2100_000.png
2,180,0.1,0,0,135419,7108,142527,images/run_aed3d067-1a4e-484e-8c70-a27344db5ea5_fuels-dens_2100_000.png
2,195,0.1,0,0,135423,11394,146817,images/run_127e8928-b463-4946-95c2-4910518a206c_fuels-dens_2100_000.png
8,180,0.1,1,1,135401,48385,183786,images/run_297ca4d1-86aa-4e67-83a7-a16d7e4e4e44_fuels-dens_2100_000.png
5,180,0.1,0,0,119749,11340,131089,images/run_b049f5d2-167c-4821-83d3-3d4a97c7d835_fuels-dens_2100_000.png
2,195,0.1,0,0,119226,1109,120335,images/run_03b3541b-caa9-44b9-86ca-58d9ef94b375_fuels-dens_2100_000.png
8,240,0.1,1,1,135368,46686,182054,images/run_9114392b-3d6e-42cf-9291-f83ad6b6b84f_fuels-dens_2100_000.png
3,240,0.1,0,0,118726,837,119563,images/run_b12b8213-1303-4249-8757-53df29665e8e_fuels-dens_2100_000.png
2,180,0.1,0,0,135353,7345,142698,images/run_abde19d1-2cc1-47c0-875b-9e5dcd533f11_fuels-dens_2100_000.png
2,255,0.1,0,0,118425,0,118425,images/run_36853043-3dfa-4dd1-8d2c-500b1a3f3411_fuels-dens_2100_000.png
2,255,0.1,0,0,135402,10974,146376,images/run_a3eb2338-707c-41ef-831b-4762d4448b68_fuels-dens_2100_000.png
3,255,0.1,0,0,135419,7584,143003,images/run_c7e6002e-c635-4309-9826-ba29e426c0e8_fuels-dens_2100_000.png
5,180,0.1,0,0,135422,23167,158589,images/run_995e4a17-c59e-4296-8d00-8cf728bef29e_fuels-dens_2100_000.png
2,255,0.1,0,0,135420,5544,140964,images/run_280a5d1b-6a62-4bb3-a5c0-aeb88f6ec185_fuels-dens_2100_000.png
3,240,0.1,0,0,135423,10699,146122,images/run_131421cc-65e9-4706-b77a-8ddc588e0d21_fuels-dens_2100_000.png
3,255,0.1,0,0,118591,729,119320,images/run_c8fb33a3-a1fb-4674-ad3e-6146f990478e_fuels-dens_2100_000.png
2,180,0.1,0,0,135427,10516,145943,images/run_dcfda2e3-cf63-47cc-b73d-1aec15b8bdf0_fuels-dens_2100_000.png
2,180,0.1,0,0,119114,736,119850,images/run_ff610d15-af45-470a-a8a7-25f3d8a788e8_fuels-dens_2100_000.png
8,255,0.1,1,1,135401,44637,180038,images/run_d8269c04-348d-47bf-8f40-59d451b9d7d4_fuels-dens_2100_000.png
8,255,0.1,1,1,135413,40586,175999,images/run_1eb84123-c65c-4eba-8ef0-a52256bdfb8c_fuels-dens_2100_000.png
2,255,0.1,0,0,135225,5328,140553,images/run_1c3eaea3-aae6-48eb-a2c0-42798fc798b5_fuels-dens_2100_000.png
2,240,0.1,0,0,135340,7507,142847,images/run_1a9e521f-4152-4b22-829b-ca4fb7108e04_fuels-dens_2100_000.png
8,240,0.1,1,1,135411,48590,184001,images/run_2fcf3d1d-c424-4d45-8526-8c773d41e338_fuels-dens_2100_000.png
12,180,0.1,0,1,119410,45029,164439,images/run_660e42f1-7ac8-4f62-b488-7b71d81198b1_fuels-dens_2100_000.png
12,180,0.1,1,1,135338,47866,183204,images/run_e5d59bf5-dc8d-4443-9451-2c84b4520dbd_fuels-dens_2100_000.png
5,195,0.1,0,0,119403,18533,137936,images/run_722f51e4-daca-4764-a10b-f2a9f091fdca_fuels-dens_2100_000.png
2,225,0.1,0,0,135302,9241,144543,images/run_f7adc337-6fdb-4799-bef6-56c9a865635c_fuels-dens_2100_000.png
2,255,0.1,0,0,118479,677,119156,images/run_3d3e1104-6795-40f0-a221-0a997f019059_fuels-dens_2100_000.png
2,240,0.1,0,0,118312,1112,119424,images/run_59ef109e-9f1e-40f7-85e5-f3ada6eaef66_fuels-dens_2100_000.png
8,240,0.1,1,1,120327,47014,167341,images/run_f6a8ffc6-6c6e-4d56-88d6-fd4ae6219d7e_fuels-dens_2100_000.png
3,225,0.1,0,0,135424,11851,147275,images/run_8f507f54-6878-4d3f-a7cf-28bc52203aec_fuels-dens_2100_000.png
3,180,0.1,0,0,119408,4091,123499,images/run_ea3294bc-cdfe-4e8c-930a-22bc68c2e9ab_fuels-dens_2100_000.png
3,180,0.1,0,0,135418,11960,147378,images/run_9b239284-8d5b-4467-9ad1-93d5e594156e_fuels-dens_2100_000.png
5,195,0.1,1,1,135423,46439,181862,images/run_068b2c1d-7959-47c9-a370-7b9abf54f4fc_fuels-dens_2100_000.png
2,240,0.1,0,0,135421,9544,144965,images/run_8743c8a6-7e34-49b4-83dc-57e932e792cc_fuels-dens_2100_000.png
12,180,0.1,0,1,135385,45432,180817,images/run_9792738d-9364-4a8e-9ce5-366a75315c26_fuels-dens_2100_000.png
12,225,0.2,1,1,132663,47404,180067,images/run_480c1e22-c4dc-46b6-a079-082215f35a39_fuels-dens_2100_000.png
3,180,0.2,0,0,135305,7638,142943,images/run_be2f9a71-da30-42fa-a5ae-282aff46a9ee_fuels-dens_2100_000.png
12,255,0.2,1,1,134016,36229,170245,images/run_790491ad-e768-4a10-836a-d85a405c00cc_fuels-dens_2100_000.png
2,180,0.2,0,0,132771,4212,136983,images/run_c44ac9b8-aab8-48a1-a78a-b5b2b06089be_fuels-dens_2100_000.png
3,180,0.2,0,0,135105,6598,141703,images/run_54525164-50d3-47ca-8d10-3aa4e7fd454a_fuels-dens_2100_000.png
12,195,0.2,0,1,116771,43224,159995,images/run_ee95fb3a-954c-4f13-afed-fef314da1180_fuels-dens_2100_000.png
8,180,0.2,1,1,134076,36461,170537,images/run_298ae4cf-8e2a-433c-b6b3-228da47e54fb_fuels-dens_2100_000.png
8,225,0.2,0,1,118984,41153,160137,images/run_552b0771-e373-4102-bdc7-21de3e8232e9_fuels-dens_2100_000.png
8,180,0.2,0,0,116876,12538,129414,images/run_eb072e3c-bc0c-4eab-94a6-5faa3d0fd841_fuels-dens_2100_000.png
8,225,0.2,1,1,134996,49834,184830,images/run_74db0e2d-48bc-45eb-a0ca-931da5111b8c_fuels-dens_2100_000.png
12,225,0.2,1,1,133175,50863,184038,images/run_188d8474-7f4c-4eef-a411-30294fefaa36_fuels-dens_2100_000.png
2,255,0.2,0,0,135344,2031,137375,images/run_3ce5f2c7-75a1-404d-8d1c-93f99e847478_fuels-dens_2100_000.png
8,240,0.2,0,1,135006,37468,172474,images/run_0b030870-324f-4db0-9792-728543acaff5_fuels-dens_2100_000.png
2,255,0.2,0,0,134371,1987,136358,images/run_2889855b-1b35-457d-8417-f9d101de3503_fuels-dens_2100_000.png
8,195,0.2,1,1,133229,45120,178349,images/run_46ebecc1-3c2b-4930-aed9-766bc601dd54_fuels-dens_2100_000.png
12,255,0.2,1,1,117527,37179,154706,images/run_4c4eebdd-69df-4e01-a748-d0a030598e4d_fuels-dens_2100_000.png
8,195,0.2,0,0,117142,16697,133839,images/run_e86dcc79-35d8-4d9d-b49e-e4e4bc1e9b17_fuels-dens_2100_000.png
5,255,0.2,0,0,134646,11667,146313,images/run_25a67b21-236e-4434-8126-ed83e1ce4291_fuels-dens_2100_000.png
8,225,0.2,0,1,132654,42452,175106,images/run_475827f3-9e03-4976-92be-7b79fae2012b_fuels-dens_2100_000.png
12,240,0.2,1,1,133509,43546,177055,images/run_87c90482-6919-4f5b-bfde-61eed8eb3b36_fuels-dens_2100_000.png
12,240,0.2,1,1,133560,42179,175739,images/run_c4f411cd-f563-4b5a-9424-c0962698a7dc_fuels-dens_2100_000.png
12,240,0.2,1,1,117879,45355,163234,images/run_5ad24156-41a4-4797-9378-60a94de97acb_fuels-dens_2100_000.png
12,255,0.2,1,1,134300,30461,164761,images/run_7089a160-550c-4fbc-ae4d-6d3ddf760aff_fuels-dens_2100_000.png
8,225,0.2,1,1,133475,51492,184967,images/run_9f5a6df9-2a51-4a2d-9a9c-f04bebd2cd0c_fuels-dens_2100_000.png
8,195,0.2,0,1,132482,42856,175338,images/run_e76a47f1-4992-4084-b17a-624f6a55fc8e_fuels-dens_2100_000.png
8,225,0.2,0,1,118279,37189,155468,images/run_d2a908cc-8581-4b6d-a9d4-cb1e9d44daa9_fuels-dens_2100_000.png
8,195,0.2,1,1,133139,45239,178378,images/run_c99adad6-95cc-4121-b19b-1fded2880c83_fuels-dens_2100_000.png
8,225,0.2,0,1,134930,35477,170407,images/run_11fddae1-0e69-416b-b07c-f141638b8592_fuels-dens_2100_000.png
2,180,0.2,0,0,115463,0,115463,images/run_82091b9d-aa4e-4bd1-886b-7d3336481a1a_fuels-dens_2100_000.png
2,180,0.2,0,0,133633,4092,137725,images/run_3160b0d4-d304-47e8-b3a8-a3af5a0c7202_fuels-dens_2100_000.png
8,240,0.2,1,1,135196,39915,175111,images/run_d04a9c9c-ee77-412e-8a0d-746cb543efa4_fuels-dens_2100_000.png
3,180,0.2,0,0,116766,905,117671,images/run_64d9265f-eae8-4cc0-b8bf-044aa6568712_fuels-dens_2100_000.png
8,240,0.2,1,1,118867,33884,152751,images/run_ab3e0263-081a-4ae8-90b2-5f38d5f9c278_fuels-dens_2100_000.png
5,255,0.2,1,0,135361,9228,144589,images/run_0cb1956c-110f-4dca-83ae-32a1fd91b293_fuels-dens_2100_000.png
3,195,0.2,0,0,135343,11671,147014,images/run_3c4aeddf-0058-4045-b437-445e60964bbd_fuels-dens_2100_000.png
2,195,0.2,0,0,133940,5079,139019,images/run_367becf7-a351-4be5-8e3a-563e46566e80_fuels-dens_2100_000.png
5,195,0.2,0,0,117333,9239,126572,images/run_6f2eda50-d18e-4658-bb4e-0159b4d1fdc0_fuels-dens_2100_000.png
3,225,0.2,0,0,116693,508,117201,images/run_413c5ea6-68d1-45a4-84dc-5fbdbadde4c6_fuels-dens_2100_000.png
3,225,0.2,0,0,133738,15058,148796,images/run_d5d243f8-6e09-4305-981e-469fa16ed044_fuels-dens_2100_000.png
3,225,0.2,0,0,132560,5931,138491,images/run_45b64640-c36e-417e-892d-cb4d82ec6bb7_fuels-dens_2100_000.png
5,240,0.2,0,0,117998,5068,123066,images/run_786be0ce-9be7-4891-8b01-2c0d7361e127_fuels-dens_2100_000.png
3,225,0.2,0,0,116839,538,117377,images/run_ed5c8f83-da6f-4e28-8330-8e7f4b011eac_fuels-dens_2100_000.png
3,225,0.2,0,0,135355,9762,145117,images/run_1ebedcad-46ea-46d5-9cd8-6dea4be2e718_fuels-dens_2100_000.png
3,225,0.2,0,0,135182,5950,141132,images/run_8623f484-60a3-4b8d-85f2-1d003a30f48a_fuels-dens_2100_000.png
5,180,0.2,0,0,135032,14500,149532,images/run_6c2ebbd4-7371-4a8e-a57c-dd29dc9ce56e_fuels-dens_2100_000.png
5,180,0.2,1,0,134169,16566,150735,images/run_4597cc95-c8f5-4420-a893-dd1205020f91_fuels-dens_2100_000.png
3,240,0.2,0,0,116567,0,116567,images/run_7eb4c666-99f5-412d-809b-995a6a1a8383_fuels-dens_2100_000.png
3,240,0.2,0,0,134041,7735,141776,images/run_cd697629-00a5-41e6-a7c1-689584a39e12_fuels-dens_2100_000.png
3,240,0.2,0,0,133123,5055,138178,images/run_68682549-f77f-4f4c-9259-7281aa963f4b_fuels-dens_2100_000.png
5,180,0.2,0,0,116981,7727,124708,images/run_f47b0f4d-aa61-4f11-b1cf-d2cc4a494bdd_fuels-dens_2100_000.png
3,255,0.2,0,0,115995,390,116385,images/run_dd020b41-cbfc-4e34-bebb-3d2e3ac00680_fuels-dens_2100_000.png
5,195,0.2,0,0,116691,10519,127210,images/run_47dbbf22-7689-4e58-bf38-cd3a75aa4299_fuels-dens_2100_000.png
3,240,0.2,0,0,134886,4365,139251,images/run_b3b2c71d-1517-46c0-818c-1c6019f43091_fuels-dens_2100_000.png
3,240,0.2,0,0,135371,13858,149229,images/run_ae13cc80-1dc2-43fe-b35f-20b71aa2fbce_fuels-dens_2100_000.png
3,240,0.2,0,0,116716,0,116716,images/run_cd858d9c-ee63-410f-a382-0114f52b49e9_fuels-dens_2100_000.png
5,180,0.2,0,0,132628,15160,147788,images/run_d8cebc83-4c30-411a-ae91-4c0639fadee6_fuels-dens_2100_000.png
5,180,0.2,0,0,116106,6798,122904,images/run_a5464da0-d694-411e-a998-7104a87c6c05_fuels-dens_2100_000.png
3,255,0.2,0,0,135383,4365,139748,images/run_f5771dfb-f1de-4225-9d2a-d33594075f4b_fuels-dens_2100_000.png
3,255,0.2,0,0,134943,3191,138134,images/run_c25aec56-3acf-4280-8dd0-5e5a130aec40_fuels-dens_2100_000.png
5,225,0.2,0,0,117752,11674,129426,images/run_b12ea46a-ad94-4570-adfd-18e783a73fd9_fuels-dens_2100_000.png
5,225,0.2,1,1,133873,38487,172360,images/run_80b50a18-8004-4111-85a6-9d20f77aea56_fuels-dens_2100_000.png
3,255,0.2,0,0,133449,3610,137059,images/run_4398f537-314d-4dc7-ab0c-fb179876adf1_fuels-dens_2100_000.png
3,255,0.2,0,0,134681,5886,140567,images/run_27b864d9-9553-4e40-a997-5a93912f7859_fuels-dens_2100_000.png
3,255,0.2,0,0,116346,0,116346,images/run_e662589a-8b8e-4694-a9a9-890d8d9b1129_fuels-dens_2100_000.png
2,195,0.2,0,0,115425,0,115425,images/run_71032e79-fa46-4ac4-bbc7-95d045050336_fuels-dens_2100_000.png
5,240,0.2,1,1,134458,31625,166083,images/run_9e7ca4a3-19e8-4de1-831b-9dfe5f0d6cff_fuels-dens_2100_000.png
3,195,0.2,0,0,132714,6816,139530,images/run_5c2ef7c4-ed1d-4cd1-836e-b842baab3e1c_fuels-dens_2100_000.png
2,195,0.2,0,0,132106,5203,137309,images/run_b266d956-3fe6-49eb-bcd7-bd41f6740076_fuels-dens_2100_000.png
5,255,0.2,0,0,135106,10891,145997,images/run_84202043-096e-42c3-b52f-250e5264115a_fuels-dens_2100_000.png
2,225,0.2,0,0,115836,0,115836,images/run_b4f4b8a0-827c-4d9f-af94-ddc7ac9f2c40_fuels-dens_2100_000.png
2,225,0.2,0,0,134088,6511,140599,images/run_dabbc3f4-9b0b-4ba7-839e-a41171d70d07_fuels-dens_2100_000.png
2,225,0.2,0,0,132185,4759,136944,images/run_fd4eaede-e77d-40a0-b07f-4f7902641d4e_fuels-dens_2100_000.png
8,180,0.2,0,1,132619,32532,165151,images/run_0bec5c3b-af03-4b16-9905-0cb11dbf0e42_fuels-dens_2100_000.png
8,180,0.2,1,1,132192,34872,167064,images/run_dd3d0b12-ae22-4d68-8606-dfac2dc1b92e_fuels-dens_2100_000.png
5,255,0.2,0,0,118018,1044,119062,images/run_742ce956-404e-4530-a814-3a0be1f1793c_fuels-dens_2100_000.png
2,240,0.2,0,0,115327,0,115327,images/run_82b8e0ea-cb9c-4d1b-8537-45e1d0d454f2_fuels-dens_2100_000.png
2,240,0.2,0,0,133703,4565,138268,images/run_b5a1ab25-4f95-47b7-9ed9-f915ba05d331_fuels-dens_2100_000.png
2,240,0.2,0,0,132399,3060,135459,images/run_32266df2-20ee-4217-8cc3-d0a57213c61a_fuels-dens_2100_000.png
3,195,0.2,0,0,116877,1559,118436,images/run_c79186c3-ac22-4756-a3d7-29aadd873614_fuels-dens_2100_000.png
3,195,0.2,0,0,134568,6726,141294,images/run_68a295bd-1942-4083-bafc-7de2287b503f_fuels-dens_2100_000.png
5,240,0.2,0,0,135078,17447,152525,images/run_5b4b1c33-8029-47ee-94e2-dea3eef6f799_fuels-dens_2100_000.png
5,240,0.2,1,1,135351,24146,159497,images/run_29a46984-dac1-4377-8501-e0c2d8e1b7ef_fuels-dens_2100_000.png
5,240,0.2,0,0,118146,5309,123455,images/run_bc64985f-84cd-4ead-a281-728b084f2915_fuels-dens_2100_000.png
3,195,0.2,0,0,133159,11334,144493,images/run_307a10c2-4c56-45c0-8b65-d169799d80db_fuels-dens_2100_000.png
3,195,0.2,0,0,116336,1318,117654,images/run_b113e9da-03ae-454b-bf9b-1b21167fb2e6_fuels-dens_2100_000.png
5,225,0.2,0,0,117746,10125,127871,images/run_f4cedbfc-1fd3-4629-8d7e-db2062d706ef_fuels-dens_2100_000.png
3,180,0.2,0,0,132908,6142,139050,images/run_079b3588-1395-4c91-9d44-c0f10831cfde_fuels-dens_2100_000.png
3,180,0.2,0,0,133971,9178,143149,images/run_6c720f71-1e94-47c3-9c0a-5e8ed2fffaea_fuels-dens_2100_000.png
3,180,0.2,0,0,116347,180,116527,images/run_7800964a-8763-4c7e-9fae-45aba8dac19a_fuels-dens_2100_000.png
5,240,0.2,1,0,133834,20607,154441,images/run_c0058552-f2b9-43fa-8521-a36d71bfe212_fuels-dens_2100_000.png
5,225,0.2,1,1,135320,27655,162975,images/run_e1d56c72-c64b-48cf-8328-5fedae7d04e5_fuels-dens_2100_000.png
5,255,0.2,0,0,117907,1216,119123,images/run_0339dc92-9f0d-457d-93a4-c98dcaeda6a1_fuels-dens_2100_000.png
5,255,0.2,1,0,134461,18608,153069,images/run_d6eb30cd-90bc-47da-94b3-41ec1c133efe_fuels-dens_2100_000.png
5,255,0.2,0,0,133455,13766,147221,images/run_fd8e82e9-26b8-4d2a-a46b-7717a2890795_fuels-dens_2100_000.png
2,255,0.2,0,0,132140,1671,133811,images/run_2235e192-5b4a-45ed-9bb9-b5fcabe9618f_fuels-dens_2100_000.png
2,255,0.2,0,0,133928,3066,136994,images/run_92353d6d-5d9d-4a82-b81e-c396388bb379_fuels-dens_2100_000.png
2,255,0.2,0,0,115214,0,115214,images/run_f7746733-0cea-44d1-8a4f-098779816f9e_fuels-dens_2100_000.png
12,225,0.2,1,1,117553,42559,160112,images/run_5d6b1b25-f2a9-4fdc-9a7d-54099b1748f4_fuels-dens_2100_000.png
8,240,0.2,1,0,118558,28507,147065,images/run_8e599383-8423-4c5b-9f28-baf09a7fef50_fuels-dens_2100_000.png
8,255,0.2,0,0,118545,6046,124591,images/run_218d072f-5b36-426b-80cb-9d02d96f22a3_fuels-dens_2100_000.png
2,180,0.2,0,0,115307,562,115869,images/run_6b97b1a3-61f4-4a5b-83f8-03d0874c1c0b_fuels-dens_2100_000.png
2,180,0.2,0,0,135286,5013,140299,images/run_ac9dc69e-b37c-4eec-83b1-bc6a9c7add43_fuels-dens_2100_000.png
2,180,0.2,0,0,133336,4003,137339,images/run_cce8003f-0a76-4e70-bfe0-bd958dcacb86_fuels-dens_2100_000.png
2,195,0.2,0,0,134635,5050,139685,images/run_6a2e315c-c25a-4634-b5e4-66749889fb72_fuels-dens_2100_000.png
12,225,0.2,1,1,117812,42114,159926,images/run_c009add3-6955-4254-9c70-34c1c667fe29_fuels-dens_2100_000.png
12,225,0.2,1,1,132235,51336,183571,images/run_eb781dea-97eb-4642-91f6-5a60769c0682_fuels-dens_2100_000.png
5,225,0.2,0,0,117788,9380,127168,images/run_3992a1d7-6aad-46dd-9327-79076ba9dd70_fuels-dens_2100_000.png
5,195,0.2,0,0,117170,9991,127161,images/run_7552caa6-ae58-4da8-954c-ba850d66aaba_fuels-dens_2100_000.png
12,225,0.2,1,1,132589,47658,180247,images/run_65a406da-31ad-4f8c-b7db-e789ff691cda_fuels-dens_2100_000.png
2,195,0.2,0,0,115460,130,115590,images/run_93a15bf1-3993-4fdd-8044-acb8c70ee1a3_fuels-dens_2100_000.png
2,195,0.2,0,0,135320,6235,141555,images/run_47169e46-d955-4327-9815-7b1af2df4e3d_fuels-dens_2100_000.png
5,195,0.2,1,1,134935,24220,159155,images/run_7b9237cf-8006-4d4c-b6ab-d64b4097b2c2_fuels-dens_2100_000.png
5,225,0.2,1,1,134697,42472,177169,images/run_1d7823f0-6990-40b6-a101-c42a318327ec_fuels-dens_2100_000.png
12,255,0.2,1,1,134265,32870,167135,images/run_55292c4c-b388-4c70-b4ac-63866d00c0da_fuels-dens_2100_000.png
12,240,0.2,1,1,134603,44041,178644,images/run_cb7003bf-c7aa-41fe-b793-88efa5bfd062_fuels-dens_2100_000.png
2,225,0.2,0,0,134624,4281,138905,images/run_9872c3b8-b5de-4506-8070-763b48ad853e_fuels-dens_2100_000.png
2,225,0.2,0,0,135386,5300,140686,images/run_8b4c2655-1d2e-4706-9659-8de4fe1ab83b_fuels-dens_2100_000.png
2,225,0.2,0,0,115938,355,116293,images/run_c2a69409-3bd7-47cd-92fa-939d93e9193f_fuels-dens_2100_000.png
5,255,0.2,1,0,134717,16302,151019,images/run_91228b3e-9ae8-4084-83a3-d05d83b22405_fuels-dens_2100_000.png
5,255,0.2,0,0,117930,1800,119730,images/run_dde28dcc-b289-42ff-b479-7982a1f7a149_fuels-dens_2100_000.png
12,195,0.2,1,1,116410,40977,157387,images/run_7d707029-c306-4e34-8d08-93b06a5255bc_fuels-dens_2100_000.png
12,255,0.2,1,1,117671,35730,153401,images/run_362cff7e-2d16-4513-be97-0f1bf9980395_fuels-dens_2100_000.png
12,255,0.2,1,1,134887,29963,164850,images/run_3f840be7-02ab-44aa-b087-614390a47c47_fuels-dens_2100_000.png
12,195,0.2,1,1,131950,46431,178381,images/run_8ef0a9ec-a68e-42a9-b559-e53bc343bc8a_fuels-dens_2100_000.png
12,195,0.2,0,1,131206,42911,174117,images/run_06b3e100-075d-4c27-a12f-6932a559a9c8_fuels-dens_2100_000.png
5,240,0.2,0,0,134565,14983,149548,images/run_aafb0d76-d76f-4eb1-8e34-9d42791bd856_fuels-dens_2100_000.png
5,240,0.2,1,1,134916,31409,166325,images/run_627ef3ea-8e17-4ff9-a920-942210f0b524_fuels-dens_2100_000.png
2,255,0.2,0,0,115359,289,115648,images/run_a9cea3c9-6534-48fc-8eee-008c13406485_fuels-dens_2100_000.png
5,240,0.2,0,0,117909,4616,122525,images/run_6acc4a86-5366-45d2-8c85-a3d7d9a0311a_fuels-dens_2100_000.png
5,180,0.2,0,0,116550,8296,124846,images/run_dd445954-6765-46eb-aacd-0e6369fcf8a5_fuels-dens_2100_000.png
12,240,0.2,1,1,134291,49225,183516,images/run_5e225b85-7c80-4794-a384-c38c5a7d894e_fuels-dens_2100_000.png
2,195,0.2,0,0,133845,4802,138647,images/run_a7908708-0aa4-4f51-94ad-c3629f089723_fuels-dens_2100_000.png
2,195,0.2,0,0,115927,452,116379,images/run_85311eed-6824-4a0b-bcfd-440b3515ee62_fuels-dens_2100_000.png
2,180,0.2,0,0,135372,5053,140425,images/run_8b30c930-2a1d-4dc4-a3a9-66c1623567d6_fuels-dens_2100_000.png
2,180,0.2,0,0,116094,0,116094,images/run_39a747d7-f253-49d9-86f9-0bed366e923d_fuels-dens_2100_000.png
12,255,0.2,1,1,118476,34155,152631,images/run_cac534ab-f49b-4820-bb9b-18d06bf11124_fuels-dens_2100_000.png
12,255,0.2,1,1,133938,30462,164400,images/run_862628c1-3e85-4c10-ad85-4e8d6a193906_fuels-dens_2100_000.png
12,255,0.2,1,1,133031,35865,168896,images/run_b9ea1ad9-c532-47be-a5d7-589819401824_fuels-dens_2100_000.png
3,195,0.2,0,0,134609,6770,141379,images/run_315d1bb9-896c-4965-9c3c-bcb87a665b46_fuels-dens_2100_000.png
2,240,0.2,0,0,134256,4104,138360,images/run_3c1c33ed-a29d-475f-a580-7dc7b16fde4d_fuels-dens_2100_000.png
3,195,0.2,0,0,135294,10921,146215,images/run_8cab3dd8-23c5-47ac-b68c-c69b18e49d00_fuels-dens_2100_000.png
2,255,0.2,0,0,115114,0,115114,images/run_47b98161-4278-4a6d-bc58-3a3be285e7f1_fuels-dens_2100_000.png
2,255,0.2,0,0,134929,2601,137530,images/run_8172caec-886a-467d-9578-24594cb2fdf7_fuels-dens_2100_000.png
2,255,0.2,0,0,133683,2427,136110,images/run_a2515c9c-560b-44bf-aeee-2b5b96c696d2_fuels-dens_2100_000.png
3,180,0.2,0,0,134888,6527,141415,images/run_2eba8705-713a-4103-b176-7a1836f2ba5c_fuels-dens_2100_000.png
3,180,0.2,0,0,135273,8988,144261,images/run_967a3339-c5d9-4440-914a-efbfcb099faf_fuels-dens_2100_000.png
3,180,0.2,0,0,116611,1072,117683,images/run_e1595068-915c-4f2d-ab9e-3b090491b044_fuels-dens_2100_000.png
3,195,0.2,0,0,116558,1463,118021,images/run_77f5d266-070b-4877-ad4d-b21c1bea981d_fuels-dens_2100_000.png
3,225,0.2,0,0,116829,795,117624,images/run_a782e8f9-c1d9-41a9-8c05-98ecabd3c6ff_fuels-dens_2100_000.png
3,225,0.2,0,0,135225,11706,146931,images/run_cc8ac729-acad-4cba-bbe5-7dcc1cb125d4_fuels-dens_2100_000.png
3,225,0.2,0,0,134316,6132,140448,images/run_76049994-f0ae-493c-93ca-3129e94ec217_fuels-dens_2100_000.png
3,255,0.2,0,0,134645,3669,138314,images/run_9d93ef65-2d76-44dd-bd82-aaaaf387c9ce_fuels-dens_2100_000.png
3,255,0.2,0,0,135061,6135,141196,images/run_b1118c49-9bd7-487b-92a8-92dc7126025e_fuels-dens_2100_000.png
3,255,0.2,0,0,116327,0,116327,images/run_26874805-679f-470d-9031-e5be54402845_fuels-dens_2100_000.png
2,225,0.2,0,0,115962,435,116397,images/run_727e2694-74fa-4d9a-96f7-6e81e986de74_fuels-dens_2100_000.png
2,225,0.2,0,0,135292,4712,140004,images/run_b5a9a87d-4512-4a3d-8958-10d874292f56_fuels-dens_2100_000.png
2,225,0.2,0,0,133725,4604,138329,images/run_7520e3f2-5181-43d2-ac04-f9d03e7c2ddc_fuels-dens_2100_000.png
12,240,0.2,1,1,118219,45807,164026,images/run_31c46bde-d5b1-4190-b4d8-55b8b38660bf_fuels-dens_2100_000.png
12,240,0.2,1,1,133323,48143,181466,images/run_986ba273-cc2b-4292-81b9-f5ca0916b6fe_fuels-dens_2100_000.png
12,240,0.2,1,1,132946,46783,179729,images/run_b4023e8e-3e6e-49fa-9c18-4de8379ee1f8_fuels-dens_2100_000.png
3,240,0.2,0,0,134467,5308,139775,images/run_b74bea19-469c-444e-bac2-cb4222a118ea_fuels-dens_2100_000.png
3,240,0.2,0,0,134803,8163,142966,images/run_3d20eac0-d58c-473f-ba53-eb6c160dfe55_fuels-dens_2100_000.png
3,240,0.2,0,0,116929,0,116929,images/run_6ef7c271-aa4f-4091-a8b4-2b3f554542a4_fuels-dens_2100_000.png
2,240,0.2,0,0,115733,0,115733,images/run_e72d1aad-00d8-4989-b068-24e475679ae3_fuels-dens_2100_000.png
2,240,0.2,0,0,135294,4436,139730,images/run_a410c164-d655-4d4d-8ff7-b0fa9e890db5_fuels-dens_2100_000.png
2,180,0.2,0,0,134933,4388,139321,images/run_0c7dceb7-370b-4fdb-a215-a4f28d5e5b7a_fuels-dens_2100_000.png
2,195,0.2,0,0,135398,5579,140977,images/run_69556dad-f03c-4d70-8096-be2eee60d553_fuels-dens_2100_000.png
12,240,0.2,1,1,117557,43071,160628,images/run_b4d1c749-842e-4b34-94fa-cbadce1cb1c0_fuels-dens_2100_000.png
8,180,0.2,1,1,132969,34488,167457,images/run_631ac5e8-9ba4-4e0a-bddf-b985b8b532de_fuels-dens_2100_000.png
8,225,0.2,1,1,134153,41838,175991,images/run_20387d0f-a0bc-49d7-8330-0e33dd82c02f_fuels-dens_2100_000.png
2,240,0.2,0,0,115601,0,115601,images/run_68fe6f4b-fe46-4db3-94c8-ed6ae1df5ce6_fuels-dens_2100_000.png
12,180,0.2,1,1,132689,40459,173148,images/run_ab4cd043-fc4c-421a-af10-48002beb49a7_fuels-dens_2100_000.png
12,180,0.2,1,1,134162,41575,175737,images/run_8aeaed0e-f16c-434a-a5b0-0e711faa1017_fuels-dens_2100_000.png
12,180,0.2,1,1,115185,30309,145494,images/run_4e8ceabd-06fc-451c-ace1-f5a0349d2592_fuels-dens_2100_000.png
12,180,0.2,1,1,115821,36692,152513,images/run_8caa7938-3545-414a-b94f-932ce068e086_fuels-dens_2100_000.png
12,195,0.2,1,1,134081,41823,175904,images/run_a1ead00c-b295-4bcf-92e0-c15e13b523c1_fuels-dens_2100_000.png
12,195,0.2,1,1,133633,45122,178755,images/run_1bcadd96-4d2e-4e00-a1d2-08ee0dbe0c29_fuels-dens_2100_000.png
8,240,0.2,1,1,118289,35878,154167,images/run_5b13b586-6946-4e3e-92b5-6356cbeecc32_fuels-dens_2100_000.png
12,180,0.2,1,1,133383,42102,175485,images/run_e6c008e7-95b9-4733-8057-43a98f9fa025_fuels-dens_2100_000.png
8,240,0.2,1,1,134543,43124,177667,images/run_6f347042-4d2f-4cae-a6ca-e97ec630705c_fuels-dens_2100_000.png
8,240,0.2,1,1,134272,35291,169563,images/run_1c03f801-4b02-42dc-9ce4-d1aa9a40c67a_fuels-dens_2100_000.png
12,180,0.2,1,1,134009,40185,174194,images/run_15b6b4a2-07db-4e52-a7b5-7729c3deb7b8_fuels-dens_2100_000.png
8,255,0.2,1,0,118437,13412,131849,images/run_aaa05474-3dcc-4fff-ad5a-dd0ac19c7910_fuels-dens_2100_000.png
2,240,0.2,0,0,135311,4423,139734,images/run_ee42b86d-2a37-4ae8-a2e9-27078e9fd73d_fuels-dens_2100_000.png
2,240,0.2,0,0,134716,3939,138655,images/run_feb0738e-9855-4eff-8966-1083d90537f9_fuels-dens_2100_000.png
8,255,0.2,1,0,118327,10801,129128,images/run_0bf74442-e502-4d58-b7c5-b3c1ebb6f137_fuels-dens_2100_000.png
8,255,0.2,1,1,134775,29086,163861,images/run_96cfea7c-faa8-4587-af91-213d6a643bfb_fuels-dens_2100_000.png
12,225,0.2,1,1,117734,42740,160474,images/run_01697db3-b487-4ef6-80d5-2b055c4a07ae_fuels-dens_2100_000.png
12,225,0.2,1,1,134506,51167,185673,images/run_a13e4d57-a5b8-439a-a4d6-f8dd210d4ac8_fuels-dens_2100_000.png
8,225,0.2,1,1,134114,50003,184117,images/run_7dbefa70-e1b3-4004-8c36-702a4f88963a_fuels-dens_2100_000.png
8,195,0.2,1,1,134412,44525,178937,images/run_c393322a-888b-4458-87ec-4636a25b3d48_fuels-dens_2100_000.png
12,195,0.2,1,1,132835,46938,179773,images/run_103b31d5-2a95-4c9c-aff1-e2404997e37c_fuels-dens_2100_000.png
12,195,0.2,0,1,116527,39931,156458,images/run_b9038368-8407-4a9b-b84f-a83f8bf32eed_fuels-dens_2100_000.png
8,255,0.2,1,1,135197,28794,163991,images/run_0af62715-ca0b-4e7c-9367-1c8d9640a344_fuels-dens_2100_000.png
12,180,0.2,1,1,132550,42166,174716,images/run_a7cd9336-7c4a-4c34-bb18-bf68fa2bc922_fuels-dens_2100_000.png
8,255,0.2,1,1,134877,29938,164815,images/run_7acb3322-92de-45cf-b2ef-d88234b7a8dc_fuels-dens_2100_000.png
12,180,0.2,0,1,132267,39444,171711,images/run_76c8511a-af9c-4f5d-ad17-db4596e21d3c_fuels-dens_2100_000.png
8,240,0.2,1,1,134150,39385,173535,images/run_ed5876e5-263e-4b91-b426-7f2301387613_fuels-dens_2100_000.png
5,195,0.2,1,1,133491,33667,167158,images/run_1f994a2a-188e-4409-920b-238785859b5b_fuels-dens_2100_000.png
8,180,0.2,0,1,134660,18671,153331,images/run_f37e1f7b-003d-4b73-bfd6-1bbc3855b39f_fuels-dens_2100_000.png
12,225,0.2,1,1,134212,47618,181830,images/run_77406ab4-62d0-45b3-a3eb-c5e34187e099_fuels-dens_2100_000.png
8,240,0.2,1,1,133891,37777,171668,images/run_618e9f2d-9f1d-449e-b637-01428f4e5c8b_fuels-dens_2100_000.png
12,195,0.2,0,1,132429,43343,175772,images/run_3c952e09-55c1-48e6-aaf3-e8ee2a73ab79_fuels-dens_2100_000.png
12,255,0.35,1,0,110008,859,110867,images/run_9ba99282-89e8-4d64-be0f-bc03acc59416_fuels-dens_2100_000.png
12,255,0.35,1,1,105991,11909,117900,images/run_7abf79b0-aaab-4409-a7b4-c987326061c7_fuels-dens_2100_000.png
2,255,0.35,0,0,105522,0,105522,images/run_a19939b2-e70c-4538-abd7-420665b3c8e2_fuels-dens_2100_000.png
2,240,0.35,0,0,124603,964,125567,images/run_fb5f8be2-8f90-42d4-834f-48179e7908d2_fuels-dens_2100_000.png
8,225,0.35,0,1,123676,26094,149770,images/run_ccf20925-a4aa-46f4-8a75-ca0d26c30438_fuels-dens_2100_000.png
2,255,0.35,0,0,102180,529,102709,images/run_508d740e-e91c-4b5c-bb8b-b7867723a898_fuels-dens_2100_000.png
3,225,0.35,0,0,66447,2491,68938,images/run_cf198727-8f0c-4579-9c52-a9a1c0070c54_fuels-dens_2100_000.png
5,225,0.35,0,0,122578,9405,131983,images/run_b5c451e3-bf0f-4bc2-b5f6-04f5110889d8_fuels-dens_2100_000.png
2,180,0.35,0,0,119098,1398,120496,images/run_bb3da6e9-a192-4659-b5b9-8a2210db436a_fuels-dens_2100_000.png
2,180,0.35,0,0,104603,0,104603,images/run_69856986-c728-478e-9361-ed6a8910d78c_fuels-dens_2100_000.png
5,225,0.35,0,0,109633,659,110292,images/run_b26a97e2-31f8-4f81-ba52-cd43b7b68b77_fuels-dens_2100_000.png
2,255,0.35,0,0,124739,0,124739,images/run_473f5368-2c59-470a-bde6-c863c9aaffa9_fuels-dens_2100_000.png
8,225,0.35,0,0,111445,7302,118747,images/run_f0bb3358-e260-4cbf-8a58-26a92934e5da_fuels-dens_2100_000.png
8,225,0.35,1,1,76583,34112,110695,images/run_b9ccc474-e8c8-4dc8-b42a-e95bb3802f49_fuels-dens_2100_000.png
3,225,0.35,0,0,124597,1882,126479,images/run_d61a0ea0-26b5-49b7-9e1f-7199665ab7e9_fuels-dens_2100_000.png
8,240,0.35,0,0,111098,4137,115235,images/run_f526013a-e008-4512-8c29-8876f265a3df_fuels-dens_2100_000.png
12,240,0.35,1,1,123730,32789,156519,images/run_23832cf2-eac1-4881-976d-f8977e8f4c5a_fuels-dens_2100_000.png
12,240,0.35,1,1,95869,30043,125912,images/run_de8be3a4-1e88-4646-95ef-a30cff723549_fuels-dens_2100_000.png
2,225,0.35,0,0,123821,1217,125038,images/run_fa598bbc-f9e7-4572-b155-bb661fa8bb55_fuels-dens_2100_000.png
3,180,0.35,0,0,106465,0,106465,images/run_f854fc36-eafa-4e32-b90e-d6932467ff79_fuels-dens_2100_000.png
2,195,0.35,0,0,124228,1367,125595,images/run_1c1065d6-0989-4e90-84a6-70931df06dc7_fuels-dens_2100_000.png
12,195,0.35,0,1,119575,14326,133901,images/run_32475b72-540b-4d9a-8b5e-02527d989091_fuels-dens_2100_000.png
12,195,0.35,1,1,80278,38489,118767,images/run_b2429533-ef71-4052-b27a-acf5d7a56a97_fuels-dens_2100_000.png
12,180,0.35,0,0,103479,9783,113262,images/run_7b09f221-3c80-4fbc-a5ac-7572e36cff75_fuels-dens_2100_000.png
5,255,0.35,1,0,63398,2533,65931,images/run_bc66c2fa-8d91-4442-b97b-279f4d7f9047_fuels-dens_2100_000.png
12,180,0.35,1,1,105107,36456,141563,images/run_f5686c0c-0b7a-4fa9-b632-8e04c8ea2bbd_fuels-dens_2100_000.png
3,180,0.35,0,0,124645,1420,126065,images/run_202e64a7-8f3e-4edb-b6e3-b305fd8a9b82_fuels-dens_2100_000.png
2,225,0.35,0,0,87766,389,88155,images/run_001a5aa3-1d00-473d-8e9c-56c6c217a025_fuels-dens_2100_000.png
8,180,0.35,0,1,121195,13058,134253,images/run_c51a3549-a184-4548-ade5-c31198c42ad3_fuels-dens_2100_000.png
2,225,0.35,0,0,104828,0,104828,images/run_7e91030f-71bd-477e-954d-58d07d54dc7d_fuels-dens_2100_000.png
3,180,0.35,0,0,104266,1695,105961,images/run_88735dff-1801-4962-9930-8026e5b93efe_fuels-dens_2100_000.png
5,255,0.35,0,0,104875,0,104875,images/run_618a7747-f084-48ff-ba4b-abbc815a9645_fuels-dens_2100_000.png
2,195,0.35,0,0,98673,1427,100100,images/run_54b7663a-c33b-4f7c-9cf8-28261207e72c_fuels-dens_2100_000.png
3,195,0.35,0,0,107090,0,107090,images/run_6ec320c8-f505-4402-bde0-662c071013bc_fuels-dens_2100_000.png
2,240,0.35,0,0,87982,818,88800,images/run_09ea0d6d-df1d-4d1d-80c5-65bfa02f56c8_fuels-dens_2100_000.png
2,240,0.35,0,0,105119,0,105119,images/run_7a0b582a-beec-4184-bdf1-d48e1ee9ad96_fuels-dens_2100_000.png
2,180,0.35,0,0,125027,1163,126190,images/run_a7635c68-4d52-40e4-85ee-23025fae6b89_fuels-dens_2100_000.png
5,240,0.35,0,0,108034,0,108034,images/run_f7fb3288-beed-40b2-a0f7-e4addcdb98a9_fuels-dens_2100_000.png
12,225,0.35,1,1,121503,36207,157710,images/run_0c6b1929-a209-4425-9bb0-7b799412d59b_fuels-dens_2100_000.png
12,225,0.35,1,1,101680,41632,143312,images/run_8f9da3e7-4375-4cdc-a748-8ae57a0e66e5_fuels-dens_2100_000.png
5,240,0.35,0,0,124005,3825,127830,images/run_a346293d-1ff3-4bd3-b68d-91a379906c2f_fuels-dens_2100_000.png
8,255,0.35,0,0,109675,365,110040,images/run_abe40569-b6bb-4996-9120-112673edd755_fuels-dens_2100_000.png
8,255,0.35,0,0,109707,6206,115913,images/run_c5b21ec0-151c-4c8f-b619-d3747020e55e_fuels-dens_2100_000.png
3,195,0.35,0,0,123898,2452,126350,images/run_20cd2c34-29cd-4363-860a-5582ad54448d_fuels-dens_2100_000.png
3,195,0.35,0,0,88023,2875,90898,images/run_29603a94-01d0-4c79-a74f-a45bf8704e86_fuels-dens_2100_000.png
8,255,0.35,0,0,125096,9779,134875,images/run_9a44ced2-3402-4199-9f80-612b885a8aef_fuels-dens_2100_000.png
2,195,0.35,0,0,105376,0,105376,images/run_b0c5303f-f943-4212-a2d8-66ae6d320477_fuels-dens_2100_000.png
3,225,0.35,0,0,107817,0,107817,images/run_371ab45d-eb3f-4a8f-935b-18d4f339c146_fuels-dens_2100_000.png
5,255,0.35,0,0,125050,1368,126418,images/run_f86faf40-7ea1-4417-b887-476eb3daf6cc_fuels-dens_2100_000.png
2,255,0.35,0,0,122315,326,122641,images/run_1a250910-836b-4c77-be2c-0a53f9ac938f_fuels-dens_2100_000.png
3,240,0.35,0,0,107206,0,107206,images/run_921ce831-f77b-499d-8360-782c1cedf22d_fuels-dens_2100_000.png
8,195,0.35,0,0,109336,5310,114646,images/run_c47ac003-aa9e-4394-9456-99bbbeb31720_fuels-dens_2100_000.png
12,225,0.35,0,1,112343,28720,141063,images/run_5c18165d-4d2d-43dc-a023-2f5a95efdacf_fuels-dens_2100_000.png
12,225,0.35,1,1,102289,43502,145791,images/run_946cbdc7-047f-4b4e-b7bb-b2b59ed1d3f5_fuels-dens_2100_000.png
12,225,0.35,1,1,123023,39934,162957,images/run_0ce283a6-600d-4c06-99b2-eab440d6c583_fuels-dens_2100_000.png
8,180,0.35,0,0,107233,5389,112622,images/run_8d9a5191-bb63-4055-bbdd-43bcd9c8b799_fuels-dens_2100_000.png
8,195,0.35,1,1,99457,11650,111107,images/run_0520953a-f0d4-4196-94fc-ad84f3c25d26_fuels-dens_2100_000.png
12,240,0.35,1,1,111014,19621,130635,images/run_d3f09f5f-7a0f-43e4-8fb9-bdadcec59dc4_fuels-dens_2100_000.png
5,255,0.35,0,0,125962,1372,127334,images/run_0eb4f173-f88d-4e10-89b3-ed4544ed0221_fuels-dens_2100_000.png
5,255,0.35,1,0,87971,4149,92120,images/run_cd7e99ed-066d-4a7d-87ef-d3d1a5edc057_fuels-dens_2100_000.png
5,255,0.35,0,0,106626,0,106626,images/run_e25ba478-3a98-4fdf-854f-bb7989ab182a_fuels-dens_2100_000.png
12,240,0.35,1,1,124820,29643,154463,images/run_6da08e34-4ed9-49d1-beaa-4aa0c135d389_fuels-dens_2100_000.png
5,240,0.35,0,0,125041,4689,129730,images/run_b6fe84ac-19af-46ba-ac6b-822d84071da6_fuels-dens_2100_000.png
5,240,0.35,1,0,71755,6371,78126,images/run_4a5507de-ec11-4760-80f5-f5e6c8badc54_fuels-dens_2100_000.png
5,240,0.35,0,0,107663,429,108092,images/run_96f69182-9cf6-4540-a1f3-3123b29a84c7_fuels-dens_2100_000.png
12,240,0.35,1,1,111758,30417,142175,images/run_7185d833-19d1-45e0-87de-d479fa34ceed_fuels-dens_2100_000.png
12,255,0.35,1,0,109226,0,109226,images/run_471f4eec-05e8-418d-92d4-21f13cb83327_fuels-dens_2100_000.png
8,225,0.35,0,1,104292,29492,133784,images/run_cbec98b3-48c0-48c0-a8c5-d534dc4f1acc_fuels-dens_2100_000.png
8,255,0.35,1,0,110264,3621,113885,images/run_e243921f-2ee0-42bb-a0ad-7ad0d0b9affd_fuels-dens_2100_000.png
8,255,0.35,0,0,129494,9140,138634,images/run_ad5b4be0-3968-4ff0-95e8-a62855aec682_fuels-dens_2100_000.png
8,255,0.35,1,0,127574,8247,135821,images/run_822af63d-78e7-4cd3-9b85-d67df349089f_fuels-dens_2100_000.png
8,255,0.35,0,0,108479,56,108535,images/run_ba08805d-eefe-43bc-8263-f69a91aa62ca_fuels-dens_2100_000.png
12,180,0.35,1,1,114999,29989,144988,images/run_5ccf6aab-6a90-402d-9f3a-bb42a3ec9b36_fuels-dens_2100_000.png
8,240,0.35,1,0,111923,1479,113402,images/run_d10b71cf-52a8-4756-bfe7-4ba31e173d43_fuels-dens_2100_000.png
12,195,0.35,1,1,111789,36196,147985,images/run_4a9e55b0-7e35-4be1-bc8b-f927e139a982_fuels-dens_2100_000.png
12,195,0.35,0,1,120821,21543,142364,images/run_df431faa-cf31-475b-b85f-98536a7964ad_fuels-dens_2100_000.png
12,180,0.35,0,1,121111,12028,133139,images/run_97418edc-50a2-49f8-a154-a5e2da78e55b_fuels-dens_2100_000.png
8,255,0.35,1,0,109683,0,109683,images/run_37c6d3b7-3c59-4b28-90d2-3b919f63bd78_fuels-dens_2100_000.png
12,255,0.35,1,1,121944,12819,134763,images/run_067904e1-23fe-41eb-ae2e-3d76998f2ebc_fuels-dens_2100_000.png
3,240,0.35,0,0,106531,0,106531,images/run_dcffb984-6771-4a7c-90c8-cab6a97803b4_fuels-dens_2100_000.png
2,225,0.35,0,0,121619,1403,123022,images/run_333769b9-b4b2-4c78-9ee7-34f7b2190a9c_fuels-dens_2100_000.png
3,225,0.35,0,0,121967,1386,123353,images/run_8df5c623-3714-4147-b55b-3921e55b236f_fuels-dens_2100_000.png
3,225,0.35,0,0,108382,0,108382,images/run_b6e3c223-69bd-407e-8945-7043ca8fddd5_fuels-dens_2100_000.png
2,240,0.35,0,0,105540,0,105540,images/run_81102ebd-83b8-44cf-b1e5-3a617159870d_fuels-dens_2100_000.png
2,240,0.35,0,0,69093,914,70007,images/run_b545257f-853c-467f-8636-e81fe390be1c_fuels-dens_2100_000.png
3,240,0.35,0,0,53976,1553,55529,images/run_f457c7fc-e0bd-444b-b732-f86c0dfca4da_fuels-dens_2100_000.png
2,240,0.35,0,0,121380,0,121380,images/run_16a9a905-70ca-4e5a-8add-6db59ab68a78_fuels-dens_2100_000.png
3,195,0.35,0,0,68124,2705,70829,images/run_09544430-0278-44ae-ac70-d7b499dafde4_fuels-dens_2100_000.png
3,195,0.35,0,0,106182,0,106182,images/run_e68ab0ed-af21-468e-9e2e-34d1e4b9956f_fuels-dens_2100_000.png
2,255,0.35,0,0,104437,0,104437,images/run_622aa95c-4b19-4713-9777-83846cc6144a_fuels-dens_2100_000.png
2,255,0.35,0,0,83532,664,84196,images/run_9b396c29-14e2-4aea-95be-5739ba48278a_fuels-dens_2100_000.png
3,180,0.35,0,0,122068,2149,124217,images/run_6d56e06b-913f-4c0b-b002-0db9bdde3520_fuels-dens_2100_000.png
3,180,0.35,0,0,86744,2381,89125,images/run_40b08b07-419f-4bd9-b718-c6c13924ea3d_fuels-dens_2100_000.png
3,180,0.35,0,0,105678,0,105678,images/run_a3f65d23-0acf-48b1-8f10-b58b365b02ce_fuels-dens_2100_000.png
3,195,0.35,0,0,121218,1653,122871,images/run_6155a34a-4b7e-4181-bc4c-ff22e84a6ad2_fuels-dens_2100_000.png
12,255,0.35,1,1,126347,16228,142575,images/run_161c6371-b311-4cb9-aadf-1b0a7d05ce51_fuels-dens_2100_000.png
3,240,0.35,0,0,123909,390,124299,images/run_06e463b4-2442-4b09-a015-f828d35427d5_fuels-dens_2100_000.png
2,225,0.35,0,0,104309,0,104309,images/run_3e344d23-caed-4327-af0f-adda3e76c2a5_fuels-dens_2100_000.png
5,225,0.35,0,0,110901,1173,112074,images/run_69fb3509-4413-4f1b-92d4-47426eb159d5_fuels-dens_2100_000.png
2,180,0.35,0,0,104334,0,104334,images/run_7d20fffa-7bed-40f8-b07e-4bf578ece7cc_fuels-dens_2100_000.png
2,180,0.35,0,0,99011,444,99455,images/run_8dc2c1af-9f4e-4359-8706-e282f7f25984_fuels-dens_2100_000.png
5,195,0.35,0,0,123012,8347,131359,images/run_3825f030-2b02-4015-9c76-1612f445ddf9_fuels-dens_2100_000.png
5,195,0.35,0,0,108078,1713,109791,images/run_8571bb63-b665-4808-abda-78f9bbf8d008_fuels-dens_2100_000.png
2,180,0.35,0,0,121221,863,122084,images/run_54055702-094e-44a5-a6a9-0cc3df9c3137_fuels-dens_2100_000.png
2,225,0.35,0,0,62098,1182,63280,images/run_ad97d3a5-ffc5-4c86-bf89-2babf9458156_fuels-dens_2100_000.png
5,180,0.35,0,0,123689,7573,131262,images/run_d5425e8d-d42b-4e42-99ab-95d816c4ba03_fuels-dens_2100_000.png
5,180,0.35,0,0,106206,1364,107570,images/run_14e42edd-9ea4-45ee-81e2-b4afc5321fe4_fuels-dens_2100_000.png
2,195,0.35,0,0,104204,0,104204,images/run_ab00deef-bef6-4944-ade6-10b4cd67923d_fuels-dens_2100_000.png
2,195,0.35,0,0,89209,1644,90853,images/run_798837d3-4a1a-4518-8bde-35eb3240b659_fuels-dens_2100_000.png
2,195,0.35,0,0,120985,1176,122161,images/run_70b0754b-916e-47a7-b9f1-b7be7da29d20_fuels-dens_2100_000.png
3,255,0.35,0,0,124002,0,124002,images/run_509195d0-c576-45be-b517-35680884d3bc_fuels-dens_2100_000.png
3,255,0.35,0,0,62726,369,63095,images/run_e837a5b3-9114-4a83-9fb8-ddd60a102087_fuels-dens_2100_000.png
3,255,0.35,0,0,105452,0,105452,images/run_429e719c-7cec-49a5-86a4-c90e6689ce63_fuels-dens_2100_000.png
5,180,0.35,0,0,93571,4706,98277,images/run_a51faf37-0257-45e0-8fff-cda04c15d10a_fuels-dens_2100_000.png
5,195,0.35,0,0,106704,1475,108179,images/run_5e70603e-fcce-44b5-ae77-a9ffa19c89d4_fuels-dens_2100_000.png
12,195,0.35,0,1,107356,12114,119470,images/run_b56ba0c7-9658-4064-b95a-d7becb1ebf3b_fuels-dens_2100_000.png
12,195,0.35,0,1,116618,22944,139562,images/run_f59444aa-b34c-4f02-8027-17d422838c03_fuels-dens_2100_000.png
5,195,0.35,0,0,108130,751,108881,images/run_a644cce6-3083-44ef-a3b1-ac755f624b80_fuels-dens_2100_000.png
3,195,0.35,0,0,119362,2312,121674,images/run_d1b45c3e-d02e-4342-b395-e22903dd1066_fuels-dens_2100_000.png
3,195,0.35,0,0,70153,3877,74030,images/run_e1096aee-344b-4a24-ab0a-6cd411566007_fuels-dens_2100_000.png
3,195,0.35,0,0,106044,0,106044,images/run_de2d049b-e4b5-4e70-8eb5-9b096f22ffe5_fuels-dens_2100_000.png
5,195,0.35,0,0,126287,9911,136198,images/run_3f011eef-a39e-406b-9a35-64eb6ebce61f_fuels-dens_2100_000.png
3,180,0.35,0,0,119761,2194,121955,images/run_448bdcef-940a-4b81-aab9-4c261cd795aa_fuels-dens_2100_000.png
3,225,0.35,0,0,106031,0,106031,images/run_0206dc4f-1011-4c02-90fe-e1825f8126a8_fuels-dens_2100_000.png
3,180,0.35,0,0,77061,2816,79877,images/run_bb6ce561-fd10-41f4-9b58-0fdf36f8777f_fuels-dens_2100_000.png
5,225,0.35,0,0,111574,3190,114764,images/run_39bb6920-acb3-46ce-9a1d-be9f9163f520_fuels-dens_2100_000.png
5,225,0.35,0,0,84626,10194,94820,images/run_dcea06d1-6a5f-438d-8365-7189dd1f8f7d_fuels-dens_2100_000.png
5,225,0.35,0,0,126748,8635,135383,images/run_3a8282b2-a9be-49f5-9d1d-bf63bb176dca_fuels-dens_2100_000.png
2,255,0.35,0,0,120116,0,120116,images/run_6aa8fd5b-2feb-492e-9426-5c50ba4a4e7c_fuels-dens_2100_000.png
2,255,0.35,0,0,78826,741,79567,images/run_66524e7a-4979-4d37-a300-83d6b200d2e7_fuels-dens_2100_000.png
2,255,0.35,0,0,103730,0,103730,images/run_c71fbb81-8424-4d8e-bf07-5219abd31855_fuels-dens_2100_000.png
5,240,0.35,0,0,109417,243,109660,images/run_ea26c1a4-5bdd-43be-bb43-a5f62af02a27_fuels-dens_2100_000.png
3,180,0.35,0,0,103943,0,103943,images/run_ff764c62-25cd-4a71-b937-807d8daeca58_fuels-dens_2100_000.png
2,240,0.35,0,0,118672,493,119165,images/run_620b8cb6-6252-41f0-90f0-84a7f2592407_fuels-dens_2100_000.png
3,225,0.35,0,0,46112,2799,48911,images/run_4d54bd09-55e7-4597-98c4-c2dc5f9e0b30_fuels-dens_2100_000.png
5,180,0.35,0,0,125592,7940,133532,images/run_ea9876f2-cf50-46b2-8e52-05f4bbdf9fe2_fuels-dens_2100_000.png
3,240,0.35,0,0,68945,1182,70127,images/run_ab4e734c-898b-4003-a5ca-7c8a03c87466_fuels-dens_2100_000.png
3,240,0.35,0,0,125438,1300,126738,images/run_25af70ad-d72c-45d4-bdb7-76d59b1fa314_fuels-dens_2100_000.png
5,180,0.35,0,0,122659,6946,129605,images/run_4fd80260-1a1f-4028-bdb4-86e5ddf252da_fuels-dens_2100_000.png
5,180,0.35,0,0,83257,5981,89238,images/run_c1aa9f34-bac7-4698-86d9-5d5767c3e5c1_fuels-dens_2100_000.png
5,180,0.35,0,0,104915,867,105782,images/run_1afaebed-76a6-40ce-8571-509fac9a653f_fuels-dens_2100_000.png
3,255,0.35,1,0,104879,0,104879,images/run_f400dea1-aa07-42bc-94a1-33fcd2804225_fuels-dens_2100_000.png
3,255,0.35,0,0,121824,340,122164,images/run_19b13d67-69ad-401e-b6f2-4b7ab025fe87_fuels-dens_2100_000.png
3,225,0.35,0,0,120407,2165,122572,images/run_a0e26aa4-78c1-49f3-abb1-54871359ba80_fuels-dens_2100_000.png
3,255,0.35,0,0,60018,1353,61371,images/run_07074c21-39a5-4af5-89b8-23c3ee7b7100_fuels-dens_2100_000.png
3,255,0.35,0,0,82199,488,82687,images/run_89130500-926c-49ce-9e52-b94626af85e4_fuels-dens_2100_000.png
3,255,0.35,0,0,125305,571,125876,images/run_7150a70e-7c48-41cb-97cd-0d55bc4a10f1_fuels-dens_2100_000.png
3,240,0.35,0,0,121148,1067,122215,images/run_91347215-d4b9-464f-897a-a9aa6dedb0b8_fuels-dens_2100_000.png
3,240,0.35,0,0,51731,2928,54659,images/run_d8ec2799-6e24-4964-a84d-0269db5ea6b9_fuels-dens_2100_000.png
3,240,0.35,0,0,104755,0,104755,images/run_b6b78a2a-e81a-4d25-896a-846c94da5766_fuels-dens_2100_000.png
5,180,0.35,0,0,106749,442,107191,images/run_3426c473-a4bd-4be1-8e7c-bc6cfa58d205_fuels-dens_2100_000.png
5,180,0.35,0,0,110635,6965,117600,images/run_9d49e566-fa91-4b8f-94d3-7cb939db8b70_fuels-dens_2100_000.png
3,255,0.35,0,0,103928,0,103928,images/run_db15ef5c-ab55-41d5-bd7f-847655b62ec7_fuels-dens_2100_000.png
12,195,0.35,1,1,92941,23763,116704,images/run_174a5fc7-c355-48bc-b778-f3774e259543_fuels-dens_2100_000.png
2,240,0.35,0,0,68135,1875,70010,images/run_19224732-f1ab-4af6-8c76-6f5ddf9f6a45_fuels-dens_2100_000.png
5,240,0.35,1,0,77412,4616,82028,images/run_85975ee3-4fd5-4739-a8a5-0592c32f06a4_fuels-dens_2100_000.png
8,195,0.35,0,1,125132,15136,140268,images/run_8f6fab43-33aa-40fb-b220-6847ac6f339f_fuels-dens_2100_000.png
12,255,0.35,1,1,125595,17457,143052,images/run_ca0d1666-c02a-4bd5-ba26-52414a85b86d_fuels-dens_2100_000.png
12,255,0.35,1,1,122034,14829,136863,images/run_be71c0b9-055f-46e8-a3b5-5fddf602b18c_fuels-dens_2100_000.png
12,255,0.35,1,0,108648,4231,112879,images/run_632c466c-7f7f-4f67-8215-ac1ed1a1f9a5_fuels-dens_2100_000.png
8,225,0.35,0,0,113165,5220,118385,images/run_27ff93d0-b2b5-4d70-8b04-a757d042a966_fuels-dens_2100_000.png
8,225,0.35,1,1,112045,23421,135466,images/run_8ae2c330-56e8-4693-82a2-dd8f6c5887e7_fuels-dens_2100_000.png
8,225,0.35,1,1,127939,28855,156794,images/run_128635e8-11f3-4625-88b7-4fb7440e0bb5_fuels-dens_2100_000.png
12,240,0.35,1,1,124666,30571,155237,images/run_bc52f123-6012-4b82-8385-53282de4b345_fuels-dens_2100_000.png
12,240,0.35,1,1,110565,21616,132181,images/run_9c5b1553-faa3-446a-a4de-c15ee8199968_fuels-dens_2100_000.png
8,240,0.35,0,0,111826,0,111826,images/run_2cf70c8d-bb6d-4780-849b-79f54f64e7a1_fuels-dens_2100_000.png
12,225,0.35,1,1,121475,33802,155277,images/run_204a5c0c-ab18-45c5-8201-f75831c8fe51_fuels-dens_2100_000.png
12,225,0.35,1,1,94249,43008,137257,images/run_e1147d23-c9ef-4772-962a-efed16448a50_fuels-dens_2100_000.png
12,225,0.35,1,1,111381,35051,146432,images/run_8b642265-9cdf-4607-a193-13f58d8b9fec_fuels-dens_2100_000.png
12,240,0.35,1,1,107056,27751,134807,images/run_b41d3139-8aa6-41ca-a8f6-f3b470f7cafb_fuels-dens_2100_000.png
2,240,0.35,0,0,105082,0,105082,images/run_c9c3fa5a-29ae-49ab-8eb9-0c8fec5aebcb_fuels-dens_2100_000.png
12,180,0.35,1,1,105402,33678,139080,images/run_2dd6ca6f-1b33-4e48-ab7d-c3087fc1cc07_fuels-dens_2100_000.png
5,240,0.35,0,0,128853,3869,132722,images/run_56d1f7fe-6e93-485a-af92-93c1a50f86a7_fuels-dens_2100_000.png
2,225,0.35,0,0,119779,453,120232,images/run_c80daa0c-34b3-431c-a350-04d596def942_fuels-dens_2100_000.png
2,225,0.35,0,0,75290,775,76065,images/run_8ace7d13-eceb-45a4-ae66-564aaceca3e1_fuels-dens_2100_000.png
2,225,0.35,0,0,104441,0,104441,images/run_dd3308e8-f8f7-478c-bb6c-c0cdd8bc1fa1_fuels-dens_2100_000.png
5,255,0.35,0,0,106503,0,106503,images/run_95473e9d-53ed-4dc5-b4fe-4fe480825429_fuels-dens_2100_000.png
5,255,0.35,1,0,129180,2025,131205,images/run_8eaa7339-7be4-4106-88dd-5a41a1261c5a_fuels-dens_2100_000.png
2,195,0.35,0,0,120564,1754,122318,images/run_fc0e2704-3514-4399-b2b4-7a06754120cf_fuels-dens_2100_000.png
2,195,0.35,0,0,103290,0,103290,images/run_10abe727-3eb5-4866-b6d4-305cab4a5c85_fuels-dens_2100_000.png
8,180,0.35,0,0,106385,4667,111052,images/run_73a186e6-8e44-4b1a-9297-f57ce27ba4bb_fuels-dens_2100_000.png
2,180,0.35,0,0,120237,1094,121331,images/run_f9224a8e-8535-4a56-9d9b-a5d2a2f719ad_fuels-dens_2100_000.png
2,180,0.35,0,0,98328,1271,99599,images/run_00998da4-889e-4e9f-a47b-685b961bb028_fuels-dens_2100_000.png
2,180,0.35,0,0,102538,0,102538,images/run_ef4cdca6-a339-4124-8be7-e6b051299093_fuels-dens_2100_000.png
2,195,0.35,0,0,81913,1075,82988,images/run_eda72d34-9add-4f13-a37c-ebc632014a5e_fuels-dens_2100_000.png
5,225,0.35,0,0,124944,8100,133044,images/run_eafb4091-2eb8-426c-87e8-41ac6f65fe1f_fuels-dens_2100_000.png
2,175,0.05,0,0,135427,14538,149965,images/run_996ce174-2416-4e03-a273-038ec0d1204f_fuels-dens_2100_000.png
3,270,0.05,0,0,119908,424,120332,images/run_21e41884-c47d-4310-b92f-e2609382c055_fuels-dens_2100_000.png
3,270,0.05,0,0,135421,13931,149352,images/run_8cc400a5-a4a2-4cc4-b598-b2356a966561_fuels-dens_2100_000.png
3,270,0.05,0,0,135422,7408,142830,images/run_5e43b148-bab1-4f4e-9b67-41cebf05a501_fuels-dens_2100_000.png
5,175,0.05,0,1,135409,33280,168689,images/run_78dc0a6d-06cf-4638-9759-787b081e9308_fuels-dens_2100_000.png
5,175,0.05,0,1,135421,37926,173347,images/run_f873ba70-d9f7-4e3d-b5c7-2c3b36c1b931_fuels-dens_2100_000.png
5,175,0.05,0,0,121325,16359,137684,images/run_713ad4f9-ce35-4e48-aef2-0fcd8504954d_fuels-dens_2100_000.png
5,175,0.05,1,1,135418,41915,177333,images/run_35ffa60f-d5e5-4f4d-bcce-9d1f911bbcd5_fuels-dens_2100_000.png
5,175,0.05,0,1,135423,34121,169544,images/run_ec449a51-4870-4b58-bd5d-e8ec29b517f4_fuels-dens_2100_000.png
5,270,0.05,1,0,120492,4974,125466,images/run_7058e666-8f3b-47f0-92d4-8b95e08bd91c_fuels-dens_2100_000.png
5,270,0.05,0,0,120468,7374,127842,images/run_76700679-4810-4f3c-926b-32c3265c2527_fuels-dens_2100_000.png
3,175,0.05,0,0,135418,13088,148506,images/run_4e2c56bb-a2c8-4fa5-b582-67934c4a6663_fuels-dens_2100_000.png
5,175,0.05,1,1,135427,39203,174630,images/run_2771ce6c-5484-46e8-a286-a3af58be4d46_fuels-dens_2100_000.png
5,270,0.05,0,0,120599,7912,128511,images/run_002b1a99-ab6d-4afe-93cf-77196379c3a0_fuels-dens_2100_000.png
5,270,0.05,1,1,135408,30408,165816,images/run_157a0be8-a141-4acc-bf4f-b52c57b91f20_fuels-dens_2100_000.png
3,270,0.05,0,0,135418,16881,152299,images/run_65efb136-a822-40ad-a893-d4d1a0ea6f3c_fuels-dens_2100_000.png
3,270,0.05,0,0,119829,1641,121470,images/run_88f10f32-0e3f-4709-a0d4-0a5c1603e4d4_fuels-dens_2100_000.png
8,175,0.05,0,1,122502,30027,152529,images/run_e789fa40-01ac-4204-94e5-a8e7b9e3bff6_fuels-dens_2100_000.png
8,175,0.05,1,1,135424,47768,183192,images/run_419ebd2d-23e1-4c1c-885d-4afb02c658fc_fuels-dens_2100_000.png
3,175,0.05,0,0,135420,13589,149009,images/run_7cefc28f-2716-45ae-a41e-94580b1f7b51_fuels-dens_2100_000.png
12,270,0.05,1,1,121662,21270,142932,images/run_805e754c-7026-4212-9717-b00029bd6035_fuels-dens_2100_000.png
12,270,0.05,1,1,135397,34266,169663,images/run_987254e5-a2df-4b9d-9fd4-fb4394af91ee_fuels-dens_2100_000.png
12,270,0.05,1,1,135249,46495,181744,images/run_24512c41-9f05-4474-b5c2-7d7688342eb8_fuels-dens_2100_000.png
5,175,0.05,0,1,135427,35860,171287,images/run_4bf68c46-c6ec-4188-b40a-f12fa30d62cf_fuels-dens_2100_000.png
2,175,0.05,0,0,120459,1781,122240,images/run_137cd5e4-80bb-4136-8bbb-fe60c6fbebbb_fuels-dens_2100_000.png
2,175,0.05,0,0,135425,15808,151233,images/run_c0f83c97-7941-47c8-a5eb-59aa5833fd39_fuels-dens_2100_000.png
12,175,0.05,1,1,135335,51154,186489,images/run_3b591502-5f1e-4f42-ac2b-55888d4040fb_fuels-dens_2100_000.png
12,175,0.05,0,1,124601,46318,170919,images/run_280d1824-cf34-4164-9689-f67b6c3371d8_fuels-dens_2100_000.png
3,270,0.05,0,0,135417,9916,145333,images/run_b9fbe220-2eec-4c0f-98e1-babe79992be3_fuels-dens_2100_000.png
3,270,0.05,0,0,135427,13293,148720,images/run_ac6d94e7-2af5-40f2-a82d-e2c0830f8a78_fuels-dens_2100_000.png
3,270,0.05,0,0,119557,1103,120660,images/run_e96129a5-bdc8-4a9d-a641-53aa9994e828_fuels-dens_2100_000.png
2,175,0.05,0,0,135391,14385,149776,images/run_c084a889-8333-4189-8917-f68c1bd365ea_fuels-dens_2100_000.png
8,270,0.05,1,1,135425,44828,180253,images/run_42d2caf4-cc25-40d4-813c-0577c4922b0a_fuels-dens_2100_000.png
8,270,0.05,1,1,135410,33092,168502,images/run_56eb9492-f0ee-4184-be7e-7b67ffcb9173_fuels-dens_2100_000.png
8,270,0.05,1,1,121129,16104,137233,images/run_81247aff-59f6-4fb6-91ff-72d6bc63e86f_fuels-dens_2100_000.png
2,270,0.05,0,0,119352,1077,120429,images/run_6760eb1e-cf47-4120-a865-88037a026d29_fuels-dens_2100_000.png
2,270,0.05,0,0,135426,10577,146003,images/run_1e6c8891-b288-43f9-acfc-51e0699cdc96_fuels-dens_2100_000.png
2,270,0.05,0,0,135390,9566,144956,images/run_9de3e6d6-0586-48e9-831a-c370d443262f_fuels-dens_2100_000.png
8,175,0.05,0,1,135410,45278,180688,images/run_027965f2-2cef-47ef-9e8b-34bc3ac03ea2_fuels-dens_2100_000.png
8,175,0.05,1,1,135413,51116,186529,images/run_64ad5d44-4fb3-4079-a658-19ce41f88cc5_fuels-dens_2100_000.png
8,175,0.05,0,1,122012,30135,152147,images/run_569de3dd-a3a5-48e5-808a-0a10acb0767b_fuels-dens_2100_000.png
3,175,0.05,0,0,120943,7217,128160,images/run_53ec35ca-15fb-46cf-9c9b-a4b45611f9e2_fuels-dens_2100_000.png
3,175,0.05,1,0,135427,20644,156071,images/run_90b73e7e-141b-4c61-81aa-877d5a5e4a97_fuels-dens_2100_000.png
8,175,0.05,0,1,121263,37695,158958,images/run_2b06dfe8-976b-45e0-9580-5de5e38ab9a8_fuels-dens_2100_000.png
8,175,0.05,1,1,135411,51339,186750,images/run_aef03e56-8b53-472d-9d60-5f454cf5ce44_fuels-dens_2100_000.png
3,175,0.05,0,0,121194,7259,128453,images/run_88bf30ac-d207-485d-a529-2ef05baaec9a_fuels-dens_2100_000.png
12,270,0.05,1,1,121464,21528,142992,images/run_e1fe1ca4-100c-4fd5-be8f-f1c26ef6a1f2_fuels-dens_2100_000.png
2,270,0.05,0,0,119837,1451,121288,images/run_d1df4d1b-d960-46f3-80d2-177e537015eb_fuels-dens_2100_000.png
12,175,0.05,1,1,122582,46664,169246,images/run_94f9a9e8-ffcc-48e4-bfd6-537955b7dea8_fuels-dens_2100_000.png
12,175,0.05,1,1,135425,49809,185234,images/run_71fe35f7-71f6-43e9-b9a6-23ec045c910b_fuels-dens_2100_000.png
12,270,0.05,1,1,135331,46980,182311,images/run_767f5102-eb5e-48a5-a008-915b3c4bcb04_fuels-dens_2100_000.png
12,175,0.05,1,1,135422,49181,184603,images/run_ca6882d4-5d43-4609-bc7b-03711eb6f343_fuels-dens_2100_000.png
12,175,0.05,1,1,121307,43609,164916,images/run_0bb621d5-687f-4f0b-842e-5392d58b0b09_fuels-dens_2100_000.png
2,270,0.05,1,0,135392,8490,143882,images/run_fc583236-89b4-4937-83da-20959b7caa66_fuels-dens_2100_000.png
12,175,0.05,1,1,135424,50950,186374,images/run_a6086793-7c57-46b7-b017-558d1fe62865_fuels-dens_2100_000.png
2,175,0.05,0,0,135394,11462,146856,images/run_7bcc58c0-b67f-4857-808b-b2b31bb0283d_fuels-dens_2100_000.png
2,175,0.05,1,0,135410,12691,148101,images/run_14e79db0-ee48-48da-8495-a0f4acc06a9c_fuels-dens_2100_000.png
8,175,0.05,1,1,135427,45765,181192,images/run_3b613110-bf06-4f7b-922d-177bd2d94e6c_fuels-dens_2100_000.png
2,175,0.05,0,0,121018,1986,123004,images/run_7a54eeb7-5853-42f6-8421-ac4272211bca_fuels-dens_2100_000.png
12,270,0.05,1,1,121645,24216,145861,images/run_4e02cf7b-ffd1-4fb1-a730-5736704805d1_fuels-dens_2100_000.png
12,270,0.05,1,1,135415,34370,169785,images/run_8c75b2a2-c7f0-4835-bf38-fd143c82c771_fuels-dens_2100_000.png
12,270,0.05,1,1,135322,47223,182545,images/run_93764f06-5631-4396-88e5-d9f053f35968_fuels-dens_2100_000.png
2,175,0.05,0,0,120973,3264,124237,images/run_beec398a-0e3d-41c6-802c-481b8aefc2aa_fuels-dens_2100_000.png
12,175,0.05,1,1,135425,49201,184626,images/run_ca624da0-2055-4c00-bd30-83e051fdb99c_fuels-dens_2100_000.png
8,270,0.05,1,1,135415,45141,180556,images/run_28350ac9-83d5-422e-846d-7e846a310fa4_fuels-dens_2100_000.png
8,270,0.05,1,1,135426,33641,169067,images/run_09e4f9bd-b648-4abb-8885-c80726e6c10b_fuels-dens_2100_000.png
2,175,0.05,0,0,135415,10276,145691,images/run_1a232043-1f36-40fe-a56e-a2c7e875754c_fuels-dens_2100_000.png
2,270,0.05,0,0,135395,12785,148180,images/run_3da99e3f-0c0a-4589-ad02-634423739f42_fuels-dens_2100_000.png
2,270,0.05,1,0,135427,12041,147468,images/run_da1f5103-f650-41a2-9a76-bbf9ffe496ec_fuels-dens_2100_000.png
8,270,0.05,1,1,135427,44058,179485,images/run_50b26d10-660b-4458-b5a2-4f5e719d0d4c_fuels-dens_2100_000.png
2,270,0.05,0,0,119863,0,119863,images/run_0028f006-ff57-4d09-9282-d9bf0ab92f44_fuels-dens_2100_000.png
8,175,0.05,1,1,135427,46819,182246,images/run_001d82e8-6447-4218-8a82-e5d66b3ee965_fuels-dens_2100_000.png
8,270,0.05,1,1,135426,33573,168999,images/run_583fe2d4-1d79-4ae3-8468-681bb3689e50_fuels-dens_2100_000.png
12,270,0.05,1,1,135423,34100,169523,images/run_bdf50481-0025-4847-9834-46bc27de22f4_fuels-dens_2100_000.png
3,175,0.05,0,0,121169,6009,127178,images/run_63b4090d-2a8e-476e-90ca-fcac8c9de318_fuels-dens_2100_000.png
8,270,0.05,1,1,121174,17487,138661,images/run_6acd9895-d9c5-40d4-84ad-19b3f1c067d5_fuels-dens_2100_000.png
12,175,0.05,1,1,135403,49520,184923,images/run_eb564200-1718-496f-ad70-49599cda3e6e_fuels-dens_2100_000.png
8,270,0.05,1,1,120947,12484,133431,images/run_015ce4de-1e1b-4775-85ef-bdce1fee9ac4_fuels-dens_2100_000.png
12,175,0.1,1,1,135328,46782,182110,images/run_36ae1bf3-6641-4922-975c-fbb705e14021_fuels-dens_2100_000.png
12,175,0.1,1,1,135258,45034,180292,images/run_6221acb0-0343-4237-9cc0-4074ba566dd8_fuels-dens_2100_000.png
8,270,0.1,1,0,120071,5888,125959,images/run_49d858b0-de4b-4d2b-b8f6-f58aeffad6dd_fuels-dens_2100_000.png
8,270,0.1,1,1,119963,15313,135276,images/run_7ff3a016-7fe5-4088-bae0-0193eafb2a1a_fuels-dens_2100_000.png
8,270,0.1,1,1,135382,29512,164894,images/run_7ea786cd-44fc-4ebb-8ce7-473ea4e99cd5_fuels-dens_2100_000.png
12,175,0.1,1,1,134817,46562,181379,images/run_fc54a192-f4e5-414c-abb1-473c17781748_fuels-dens_2100_000.png
8,270,0.1,1,1,135186,32414,167600,images/run_388e87e3-de44-4e2d-9907-34bdcaaf80d5_fuels-dens_2100_000.png
5,175,0.1,0,1,135413,21824,157237,images/run_defb7f92-85a0-4f5b-b068-1e1f97517663_fuels-dens_2100_000.png
5,175,0.1,0,1,135416,33309,168725,images/run_cce30db5-f175-48ee-81d1-3f54cb070155_fuels-dens_2100_000.png
12,175,0.1,1,1,119756,20591,140347,images/run_b6631d22-9baf-44b1-b70f-c45d8e6864ac_fuels-dens_2100_000.png
12,175,0.1,1,1,134715,45147,179862,images/run_1eac8c2c-46fd-4adf-b5b9-2435e375cb20_fuels-dens_2100_000.png
12,175,0.1,1,1,119288,41819,161107,images/run_5e025010-132e-4a83-92f0-448232d80a28_fuels-dens_2100_000.png
8,175,0.1,1,1,119963,31950,151913,images/run_cc7cd428-7787-4e40-9632-461a2f6618eb_fuels-dens_2100_000.png
8,175,0.1,1,1,135154,39861,175015,images/run_954d036f-1f3e-4f0d-be5c-0a6867aa5f4e_fuels-dens_2100_000.png
8,175,0.1,1,1,134836,42209,177045,images/run_7a3b58db-92a3-4b82-a4c7-b44af51ee285_fuels-dens_2100_000.png
3,175,0.1,0,0,135202,9030,144232,images/run_e1058fa9-917b-4933-85ca-b5dacc7d2f2a_fuels-dens_2100_000.png
3,175,0.1,0,0,119760,2428,122188,images/run_9d670ace-5dd3-4f05-8bce-a43bdd42ef61_fuels-dens_2100_000.png
3,270,0.1,0,0,118425,0,118425,images/run_a08a8594-ef28-4de2-ae96-df26f5c81d5f_fuels-dens_2100_000.png
5,270,0.1,1,1,135425,18281,153706,images/run_10395b34-9e7c-42e4-9fac-f2c6392ec79c_fuels-dens_2100_000.png
5,270,0.1,0,0,119587,1030,120617,images/run_a99669c5-9275-4746-b632-0a33d3c9c78d_fuels-dens_2100_000.png
12,270,0.1,1,1,119622,10999,130621,images/run_55f885bd-1cb2-4ea8-935a-4d42c263bef1_fuels-dens_2100_000.png
2,270,0.1,0,0,118124,0,118124,images/run_3b1b6216-918d-4a6c-9d95-1a11575d0d06_fuels-dens_2100_000.png
2,175,0.1,0,0,135029,7370,142399,images/run_616b0a0c-dd09-419f-8464-1f9ee8f638f4_fuels-dens_2100_000.png
5,175,0.1,1,1,135287,33011,168298,images/run_8f93506c-9adc-4def-981d-d30ec2f0f249_fuels-dens_2100_000.png
5,175,0.1,1,1,135178,24466,159644,images/run_eeafb1da-345c-42f8-9586-9fd117cbeb08_fuels-dens_2100_000.png
2,175,0.1,0,0,119169,815,119984,images/run_a067a78c-47a8-4b9c-9cce-d4a88d3a78e8_fuels-dens_2100_000.png
5,270,0.1,0,0,119530,4192,123722,images/run_ce701cc2-6242-4cb2-b420-c800738c67da_fuels-dens_2100_000.png
12,270,0.1,1,1,135377,41539,176916,images/run_3eb07f34-77d7-4833-a7ab-c5f9a6b20b30_fuels-dens_2100_000.png
12,270,0.1,1,1,135397,32209,167606,images/run_a4829afe-c04b-4b94-ac43-2ff3b82ce6d1_fuels-dens_2100_000.png
8,175,0.1,1,1,119671,26070,145741,images/run_8c684a8b-974b-45e0-96b2-e03962fb135e_fuels-dens_2100_000.png
8,175,0.1,1,1,135191,41031,176222,images/run_1b86d92e-d7a3-4553-9f64-d0510824574b_fuels-dens_2100_000.png
2,175,0.1,0,0,134935,6691,141626,images/run_4ff3b2eb-1b3b-4e9f-bb0c-61b706c6f1d1_fuels-dens_2100_000.png
12,270,0.1,1,1,134997,41678,176675,images/run_6b8e2631-6189-4377-a180-b0e658f50c8b_fuels-dens_2100_000.png
12,270,0.1,1,1,120491,15881,136372,images/run_d56e5859-7bd7-42fe-a8e7-955cab855de2_fuels-dens_2100_000.png
3,270,0.1,0,0,135297,5329,140626,images/run_c36208f7-76be-4362-a2bc-0bf7d8a5a7d1_fuels-dens_2100_000.png
5,175,0.1,1,1,135413,33734,169147,images/run_29996697-12a3-4d98-868f-5015e86f7d01_fuels-dens_2100_000.png
5,175,0.1,0,1,135384,28013,163397,images/run_b3efec50-3ea9-4a62-b5dc-b0480208bd1d_fuels-dens_2100_000.png
3,175,0.1,0,0,119723,3107,122830,images/run_a6b41224-1721-4c7a-9df0-03246e865fd1_fuels-dens_2100_000.png
5,270,0.1,0,0,119780,930,120710,images/run_3e6f1812-b257-4e82-88ac-1e40357acc51_fuels-dens_2100_000.png
2,270,0.1,1,0,135222,3960,139182,images/run_b176f19a-4c7e-4af8-bf6f-108310850788_fuels-dens_2100_000.png
2,270,0.1,0,0,135419,6315,141734,images/run_5d1c4c6a-0a10-4827-895c-f7fce5ad2be1_fuels-dens_2100_000.png
2,270,0.1,0,0,118007,0,118007,images/run_d58eafa4-33b4-4cbf-9c45-d09e56eb4b36_fuels-dens_2100_000.png
8,175,0.1,1,1,119453,19077,138530,images/run_2f3493ae-00c7-408f-939e-cf2fefa67c32_fuels-dens_2100_000.png
8,175,0.1,1,1,135354,47023,182377,images/run_1097511f-70ec-4613-8864-b54067c76507_fuels-dens_2100_000.png
8,175,0.1,1,1,135376,39552,174928,images/run_53e32a8f-0e4d-4ea3-bc33-e0f0e797d359_fuels-dens_2100_000.png
8,270,0.1,1,1,120131,11572,131703,images/run_6d6ebeaa-5c88-43cd-accb-dfac449d6e87_fuels-dens_2100_000.png
8,270,0.1,1,1,135378,30404,165782,images/run_b9f22de2-9d5f-4016-80e1-e5b421c8e6d0_fuels-dens_2100_000.png
8,270,0.1,1,1,135249,32546,167795,images/run_d6c6abbe-7456-4fe0-9339-d4849067ded4_fuels-dens_2100_000.png
12,175,0.1,0,1,118526,42052,160578,images/run_7ba2ffcb-af6d-471d-a1b0-fb1be32f4047_fuels-dens_2100_000.png
12,175,0.1,1,1,135310,46084,181394,images/run_54326453-cca7-4a54-876f-0d77d8f7dd43_fuels-dens_2100_000.png
12,175,0.1,1,1,135345,44521,179866,images/run_0027a212-2e4c-40a6-830a-e14de1495b29_fuels-dens_2100_000.png
12,270,0.1,1,1,119981,14357,134338,images/run_612baad6-4de7-4980-af53-a87bc4a148cf_fuels-dens_2100_000.png
12,270,0.1,1,1,135251,33506,168757,images/run_d9db027a-e2dc-464f-a64c-809590ba60b6_fuels-dens_2100_000.png
12,270,0.1,1,1,135092,42494,177586,images/run_6bb8518a-4c89-4938-9a87-b20c90c52357_fuels-dens_2100_000.png
8,175,0.1,1,1,135405,28847,164252,images/run_b4969fca-8915-4ebf-b82b-a2e66fdc32b3_fuels-dens_2100_000.png
3,270,0.1,0,0,135380,7562,142942,images/run_3c9a059c-2850-44df-8841-1b70a326f5d7_fuels-dens_2100_000.png
2,175,0.1,0,0,135352,6102,141454,images/run_4fd36cfa-8fd1-42d9-8f3a-4937b1426958_fuels-dens_2100_000.png
2,175,0.1,0,0,135426,7970,143396,images/run_b6be6a92-cac3-4799-9df6-6571cadda71c_fuels-dens_2100_000.png
2,175,0.1,0,0,119441,965,120406,images/run_ec95a4b4-7c90-4a45-b71b-6c207ac1092f_fuels-dens_2100_000.png
3,270,0.1,0,0,135407,5915,141322,images/run_4be6504a-f606-45f3-b7ec-b8a25a4ac2c5_fuels-dens_2100_000.png
3,270,0.1,0,0,118627,0,118627,images/run_4fe1dc0e-fc07-442d-9bce-d94e1623c112_fuels-dens_2100_000.png
8,270,0.1,1,1,135378,29064,164442,images/run_47b96bbc-eb82-4403-b608-d247f95bf0f9_fuels-dens_2100_000.png
3,175,0.1,0,0,135336,9579,144915,images/run_cdc548bb-db0c-47d2-a56a-02bdf3f7b369_fuels-dens_2100_000.png
2,175,0.1,0,0,119118,1160,120278,images/run_70ae74ed-c655-460e-b556-a4e87d48c4bc_fuels-dens_2100_000.png
2,270,0.1,0,0,118130,0,118130,images/run_44ea6ee6-8505-434a-92af-a765ff3a4a5f_fuels-dens_2100_000.png
3,270,0.1,0,0,118493,0,118493,images/run_c3aa32c1-d6b1-4553-8633-ebabae3236d8_fuels-dens_2100_000.png
2,175,0.1,0,0,135330,8359,143689,images/run_c585b8f6-57ac-4b59-921c-bfc15d5eda55_fuels-dens_2100_000.png
12,270,0.1,1,1,135332,32557,167889,images/run_3d6fc609-6888-4bac-a42c-7ea9588cb60f_fuels-dens_2100_000.png
8,270,0.1,1,1,135407,30091,165498,images/run_fd8d36c6-acb5-48cc-bd78-3f83ca1e25b3_fuels-dens_2100_000.png
3,175,0.1,0,0,119274,2535,121809,images/run_5d548d0f-c55a-4410-b2e9-575ffff3a93e_fuels-dens_2100_000.png
8,270,0.2,1,0,118513,1498,120011,images/run_81143e7c-7fc1-4c58-aa4e-dec17a128969_fuels-dens_2100_000.png
2,175,0.2,0,0,115547,0,115547,images/run_db0a47da-0958-476d-a823-17067c349c7f_fuels-dens_2100_000.png
2,175,0.2,0,0,132421,3819,136240,images/run_a9fca9f8-33ef-41f9-ad99-2cf1276f10f9_fuels-dens_2100_000.png
8,270,0.2,1,0,118317,691,119008,images/run_da6e7b5e-7230-4a02-a317-8fdd2f57831d_fuels-dens_2100_000.png
12,270,0.2,1,1,134641,16890,151531,images/run_2aa84c1d-b8b7-40bc-85cf-06b8f2c35b47_fuels-dens_2100_000.png
12,175,0.2,0,1,115232,20672,135904,images/run_6c9d3f67-f7ba-4a20-a06b-4f8ff3979d61_fuels-dens_2100_000.png
12,175,0.2,1,1,132463,37851,170314,images/run_95696db8-2a97-4b46-a862-5c23f5c105ab_fuels-dens_2100_000.png
12,175,0.2,1,1,131639,38707,170346,images/run_6a21eb06-b4f9-48ed-95b5-50b5a06ea53c_fuels-dens_2100_000.png
12,175,0.2,0,1,133839,18574,152413,images/run_b91c47e6-a15f-49e9-864f-c82699f732a1_fuels-dens_2100_000.png
12,175,0.2,1,1,133557,39940,173497,images/run_7010b8d6-f24b-4932-958c-afb676a9c4dd_fuels-dens_2100_000.png
12,270,0.2,1,1,134700,29726,164426,images/run_4bc4097f-4b99-4d7e-bebd-79bae66a02ef_fuels-dens_2100_000.png
12,270,0.2,1,1,134176,21227,155403,images/run_4f3fb33b-b3cd-42ed-87b4-dbb9ef348026_fuels-dens_2100_000.png
12,270,0.2,1,1,133884,27135,161019,images/run_704ef910-f6bb-424d-8ad7-eac9070412b0_fuels-dens_2100_000.png
12,270,0.2,1,1,134657,28099,162756,images/run_f56425be-4613-4b13-84f2-08d971260f72_fuels-dens_2100_000.png
5,270,0.2,0,0,134803,2114,136917,images/run_e3dfa5c7-06be-4880-9b73-e7c3e1a43c57_fuels-dens_2100_000.png
12,270,0.2,1,1,135103,28569,163672,images/run_df57525e-53b9-48a3-8605-3ef0ce5c8ad9_fuels-dens_2100_000.png
3,175,0.2,0,0,116338,675,117013,images/run_a579d5cd-ff95-4c9d-94d7-3456315e1fe2_fuels-dens_2100_000.png
8,175,0.2,1,1,133146,16692,149838,images/run_1a0bbf88-1618-4220-bac9-1778cdad9f75_fuels-dens_2100_000.png
2,270,0.2,0,0,114937,0,114937,images/run_d9a848bd-36ac-434f-99cd-1e60c39a6118_fuels-dens_2100_000.png
5,175,0.2,1,1,133643,13247,146890,images/run_1c1c4f4e-72a5-4a55-85e6-6804a027a990_fuels-dens_2100_000.png
5,175,0.2,0,0,116489,7568,124057,images/run_2324d729-ecc6-4917-acf2-e8a6d188f77b_fuels-dens_2100_000.png
2,270,0.2,0,0,134931,708,135639,images/run_a24c1861-e055-42d4-8603-71d2029f33a0_fuels-dens_2100_000.png
2,270,0.2,0,0,133747,391,134138,images/run_aece8f4c-c1cc-4eb0-b251-8638e089b727_fuels-dens_2100_000.png
3,270,0.2,0,0,115981,0,115981,images/run_c236dad2-d1c0-4786-9174-c4fd329623a1_fuels-dens_2100_000.png
5,270,0.2,0,0,117571,0,117571,images/run_e4b1aeeb-741d-4a6e-bc23-bb54f21fa7e8_fuels-dens_2100_000.png
5,175,0.2,0,0,116305,5656,121961,images/run_4a6943f0-bd7f-4230-b1e0-5124b6d2121f_fuels-dens_2100_000.png
5,175,0.2,1,1,132787,18544,151331,images/run_e7bab871-4858-4f58-a6ea-df52faa8e72b_fuels-dens_2100_000.png
5,175,0.2,1,1,132748,16242,148990,images/run_c6a043b6-9a6b-47f7-8b08-29cc98f5914d_fuels-dens_2100_000.png
3,175,0.2,0,0,134712,6937,141649,images/run_147cabb1-e728-4042-aaa1-0128727ca9a5_fuels-dens_2100_000.png
3,175,0.2,0,0,135236,8048,143284,images/run_8189ce1c-2423-4385-8d96-c8d090f2898c_fuels-dens_2100_000.png
3,270,0.2,0,0,132750,1560,134310,images/run_f93880f3-59cc-49bb-98c9-5c83844bf84b_fuels-dens_2100_000.png
3,270,0.2,0,0,134132,0,134132,images/run_b6aa39a0-188f-4bcb-bb8a-dd986cfee0ba_fuels-dens_2100_000.png
3,270,0.2,0,0,115446,108,115554,images/run_d896f5a4-75c5-4a4e-94c1-bff94fd2593b_fuels-dens_2100_000.png
5,175,0.2,1,1,134791,13513,148304,images/run_a5b701b9-07f8-4516-ba1a-07dcf4afa2f1_fuels-dens_2100_000.png
2,270,0.2,0,0,114774,0,114774,images/run_e7a251ea-f095-4e38-9641-0160dbad8900_fuels-dens_2100_000.png
2,270,0.2,0,0,132503,552,133055,images/run_4118f33e-4582-40f5-aea9-70e273a149df_fuels-dens_2100_000.png
8,175,0.2,1,1,116362,12542,128904,images/run_a03ee767-7dd8-41e2-be31-a2fee5f4faa5_fuels-dens_2100_000.png
2,175,0.2,0,0,115689,0,115689,images/run_953a3aa3-8434-454c-b3f6-9a9f8762be4f_fuels-dens_2100_000.png
2,175,0.2,0,0,134267,4109,138376,images/run_4b3746ba-c843-4471-9411-45466d7d94ea_fuels-dens_2100_000.png
8,175,0.2,1,1,134225,26551,160776,images/run_e00a58ca-d43e-4849-ae70-ca1ede3ce813_fuels-dens_2100_000.png
8,175,0.2,1,1,132130,28336,160466,images/run_05519455-c57b-4262-a352-ec966b4fcbc6_fuels-dens_2100_000.png
5,270,0.2,0,0,134490,2876,137366,images/run_41e34d07-a374-4f4f-912b-12359e7287bf_fuels-dens_2100_000.png
5,270,0.2,0,0,135163,4660,139823,images/run_ce31c97d-d5d3-4938-a452-b0a59f23061d_fuels-dens_2100_000.png
5,270,0.2,0,0,117725,0,117725,images/run_555258a2-f4a2-41fc-bd5a-510aa8dc8db6_fuels-dens_2100_000.png
3,175,0.2,0,0,116601,999,117600,images/run_f90c755c-7462-481a-9f5a-8798a13e23c4_fuels-dens_2100_000.png
3,175,0.2,0,0,134181,7707,141888,images/run_be4c7671-6c09-4fcd-b4c6-51cc85ea79cb_fuels-dens_2100_000.png
3,175,0.2,1,0,133399,6113,139512,images/run_77cd6aac-f58c-45b2-8a80-7c924cda3aef_fuels-dens_2100_000.png
12,175,0.2,1,1,130698,39083,169781,images/run_e9af5b0a-5c0e-4c28-9c54-1b1a7560922e_fuels-dens_2100_000.png
8,175,0.2,1,1,116411,13235,129646,images/run_4e1f7e57-fd75-4019-b680-d692285eefcd_fuels-dens_2100_000.png
2,270,0.2,0,0,133721,1772,135493,images/run_41a34211-d59c-4238-8557-5354ee447004_fuels-dens_2100_000.png
12,175,0.2,1,1,133308,18196,151504,images/run_dd6f7fd3-0119-4492-a936-f96f96f7ba2c_fuels-dens_2100_000.png
5,175,0.2,1,1,135159,14181,149340,images/run_9800cef8-19a0-46fa-811f-34597ad5b15e_fuels-dens_2100_000.png
5,270,0.2,0,0,134987,2232,137219,images/run_eb900098-7e94-4886-bb66-14d7e91e600e_fuels-dens_2100_000.png
2,270,0.2,0,0,115020,0,115020,images/run_6617b96c-81fd-409c-a597-060d5a304422_fuels-dens_2100_000.png
2,270,0.2,0,0,135278,1515,136793,images/run_71ae88eb-2fe4-4470-b812-5d32eba8e299_fuels-dens_2100_000.png
8,175,0.2,1,1,134571,19491,154062,images/run_12500091-c16d-4832-a052-c8ae9c4baee7_fuels-dens_2100_000.png
3,270,0.2,0,0,135330,1717,137047,images/run_1d5bdd13-6776-461d-b901-f1243e62e28e_fuels-dens_2100_000.png
3,270,0.2,0,0,134732,1227,135959,images/run_2b08ca0b-80a2-4362-9fb5-2e319c39485b_fuels-dens_2100_000.png
8,175,0.2,1,1,133427,27614,161041,images/run_6a62415e-6d55-486f-ad1a-244110bb8f81_fuels-dens_2100_000.png
2,270,0.2,0,0,134223,1145,135368,images/run_3dd58aa7-63a0-4798-90e1-37129a95ded8_fuels-dens_2100_000.png
5,270,0.2,0,0,135348,1822,137170,images/run_cc776ca2-8641-4744-b582-8c3df1a24198_fuels-dens_2100_000.png
3,175,0.2,0,0,135044,5789,140833,images/run_cccbf5ef-6611-4c30-8478-a15a9f96efd4_fuels-dens_2100_000.png
2,175,0.2,0,0,134735,4505,139240,images/run_e3776474-9db7-40d2-b910-935ce9796168_fuels-dens_2100_000.png
2,175,0.2,0,0,135368,4644,140012,images/run_4ab3e9cc-e87a-4b1f-b53e-9254a415b3a4_fuels-dens_2100_000.png
2,175,0.2,0,0,115861,0,115861,images/run_0dcc3825-9f88-41ca-9ee8-0017b295a415_fuels-dens_2100_000.png
3,175,0.2,0,0,135277,8013,143290,images/run_b4ab0809-3c98-46f3-bf27-1ca984711ab0_fuels-dens_2100_000.png
5,175,0.2,0,0,116833,5201,122034,images/run_b8b14a34-4ea8-4d05-b91c-466a796871bc_fuels-dens_2100_000.png
8,270,0.2,0,0,118108,2697,120805,images/run_59390bcc-9231-4ec5-a0b3-b0c2442bbea5_fuels-dens_2100_000.png
8,175,0.2,1,1,116481,14184,130665,images/run_8e9a8955-6cee-4dd6-b9ad-16e9613b8ecb_fuels-dens_2100_000.png
5,175,0.2,1,1,133628,14363,147991,images/run_72a99b63-2334-402b-9481-2f83b0d8b6fd_fuels-dens_2100_000.png
3,175,0.2,0,0,116935,886,117821,images/run_3792df7e-e795-40ff-9f8e-ec31dc7c121a_fuels-dens_2100_000.png
3,270,0.2,0,0,115822,0,115822,images/run_209e834e-a1b3-42de-80de-60fbac344c67_fuels-dens_2100_000.png
5,270,0.2,0,0,117582,0,117582,images/run_145dcded-e828-41eb-8952-dba78b09b3fa_fuels-dens_2100_000.png
2,175,0.35,0,0,121045,1778,122823,images/run_974506cf-bd68-4254-bb8a-c1732b7c4a33_fuels-dens_2100_000.png
2,175,0.35,0,0,97479,1449,98928,images/run_0492134e-24e9-4880-8cc0-fc8dbae32952_fuels-dens_2100_000.png
2,175,0.35,0,0,102672,0,102672,images/run_31ecf49e-80b7-404b-ad89-56248c2fc6ef_fuels-dens_2100_000.png
12,270,0.35,1,1,124654,8959,133613,images/run_839bcf82-8923-4b08-9143-db7eb03ffde6_fuels-dens_2100_000.png
3,175,0.35,0,0,81499,2661,84160,images/run_2aefd435-9e70-46f5-a4a6-3fb524fd38c7_fuels-dens_2100_000.png
3,270,0.35,0,0,95776,335,96111,images/run_065add5e-6832-4115-969a-4f43ee942476_fuels-dens_2100_000.png
8,270,0.35,0,0,122373,0,122373,images/run_0e10274d-70db-43ed-a932-1b8df05a2191_fuels-dens_2100_000.png
3,270,0.35,0,0,125936,0,125936,images/run_8fd70f18-0aeb-415a-81da-496a3f169332_fuels-dens_2100_000.png
3,175,0.35,0,0,102983,0,102983,images/run_21afd5e3-2187-4111-a1ea-aff065f9c889_fuels-dens_2100_000.png
2,270,0.35,0,0,98537,0,98537,images/run_ec6cce23-6b8f-40fd-8d27-e4fc03752c69_fuels-dens_2100_000.png
3,175,0.35,0,0,120151,2307,122458,images/run_93253cc7-5a15-4d70-a045-2e8a93c2f306_fuels-dens_2100_000.png
3,175,0.35,0,0,105946,0,105946,images/run_5d1fbd64-360c-4e1b-9ae7-fc55e1eb4150_fuels-dens_2100_000.png
3,175,0.35,0,0,106857,2835,109692,images/run_19dafda4-f6b8-4c80-bde9-a083326232bb_fuels-dens_2100_000.png
8,270,0.35,0,0,108096,0,108096,images/run_1d49df97-d42e-4ab7-bc93-a5848985e43e_fuels-dens_2100_000.png
12,270,0.35,0,0,128031,4830,132861,images/run_f6d19d05-505a-49a3-8d79-d64bc60c5b82_fuels-dens_2100_000.png
3,270,0.35,0,0,104119,0,104119,images/run_7cb4b263-0894-4176-a5a2-16edcd4ae47a_fuels-dens_2100_000.png
12,270,0.35,0,0,108147,0,108147,images/run_73988de8-9544-423e-9f3b-ff708d1b5d0b_fuels-dens_2100_000.png
8,175,0.35,1,1,122145,9545,131690,images/run_7397a714-3633-4fa7-9998-c8bfc4dbf6c2_fuels-dens_2100_000.png
5,175,0.35,0,0,104376,655,105031,images/run_2e428cf7-3ac8-46b1-9a36-9ff38ab0dbae_fuels-dens_2100_000.png
8,175,0.35,1,1,123259,13360,136619,images/run_499556fc-37be-43bd-89b0-49149c62e71d_fuels-dens_2100_000.png
8,175,0.35,1,1,119772,8747,128519,images/run_7afcb748-3ba8-4978-9c79-6673a628c49f_fuels-dens_2100_000.png
2,270,0.35,0,0,103864,0,103864,images/run_bdad352c-ef52-4eec-bb9b-8c9ea195e0b6_fuels-dens_2100_000.png
2,270,0.35,0,0,95010,223,95233,images/run_34efdfae-32e0-4593-be86-8b3221823836_fuels-dens_2100_000.png
2,270,0.35,0,0,120377,0,120377,images/run_72f7ad9c-0471-4773-b707-f9c810c4eb38_fuels-dens_2100_000.png
2,270,0.35,0,0,105301,0,105301,images/run_631d8814-aa14-4ed9-88d6-0fbd0f50eea7_fuels-dens_2100_000.png
2,270,0.35,0,0,124541,288,124829,images/run_1091c260-60b5-4fb9-b98d-d7d5e391fd27_fuels-dens_2100_000.png
2,270,0.35,0,0,108304,0,108304,images/run_600a1d1f-66cd-47d5-a6e6-3381711fcb65_fuels-dens_2100_000.png
2,270,0.35,0,0,105343,0,105343,images/run_52a50531-e185-4b83-8eee-e2911d0d9bcf_fuels-dens_2100_000.png
5,270,0.35,0,0,105882,0,105882,images/run_7e441394-0298-4bee-9669-fcfc331b9bc0_fuels-dens_2100_000.png
5,270,0.35,0,0,102365,583,102948,images/run_1ecc9a38-0e71-42f0-8f55-0e8736ec2603_fuels-dens_2100_000.png
5,270,0.35,0,0,128358,485,128843,images/run_17fcd06e-5082-4b3f-a6d4-e29b52d2852a_fuels-dens_2100_000.png
8,175,0.35,1,1,106046,3799,109845,images/run_f00c01cc-9aa2-4f3c-a8cb-8084813086b2_fuels-dens_2100_000.png
2,175,0.35,0,0,122493,787,123280,images/run_9a1e4078-4b2a-44e5-b660-054dfe4b66bb_fuels-dens_2100_000.png
2,175,0.35,0,0,104484,894,105378,images/run_e107e658-13ce-4814-bd98-3b4637891e92_fuels-dens_2100_000.png
8,175,0.35,1,1,106080,5755,111835,images/run_a007152e-6655-40f4-a7fc-6338ec34f4eb_fuels-dens_2100_000.png
8,175,0.35,1,1,111357,8759,120116,images/run_63c83740-130f-42b0-bcd6-de37347d6b54_fuels-dens_2100_000.png
2,175,0.35,0,0,103872,0,103872,images/run_4162356a-8b79-46ad-af70-e52907dbefd1_fuels-dens_2100_000.png
5,175,0.35,0,0,106011,993,107004,images/run_1409fbd4-2e94-4f74-9c8c-672e6f2bf8dd_fuels-dens_2100_000.png
12,270,0.35,0,0,107718,0,107718,images/run_324bda41-6212-433c-a9b8-ed91a81f5689_fuels-dens_2100_000.png
2,270,0.35,0,0,123377,164,123541,images/run_f7356baa-8bef-4d8c-8ead-4e68eea1d19f_fuels-dens_2100_000.png
3,175,0.35,0,0,124887,1916,126803,images/run_bd6aecfa-efa0-4d8b-a7bd-806165759f9a_fuels-dens_2100_000.png
8,270,0.35,0,0,127917,2484,130401,images/run_6603165d-b4f1-4d46-b093-56ed4debc1d4_fuels-dens_2100_000.png
12,270,0.35,1,1,125796,9017,134813,images/run_a7403fa7-76d0-4958-abb8-ae0328f6cfb7_fuels-dens_2100_000.png
12,270,0.35,0,0,126083,3236,129319,images/run_a198e165-6d0e-4139-af96-ee6f2acabc77_fuels-dens_2100_000.png
8,270,0.35,0,0,125107,2676,127783,images/run_0c4d0ae0-252a-40a7-ad9c-f2176c4d1116_fuels-dens_2100_000.png
8,270,0.35,0,0,108657,1324,109981,images/run_373fb81d-43a6-43b4-8466-7894cf68bfa1_fuels-dens_2100_000.png
8,270,0.35,0,0,107919,0,107919,images/run_282bccc7-76ea-4485-915a-ff2e3ab56d0b_fuels-dens_2100_000.png
12,175,0.35,1,1,120026,10467,130493,images/run_ce823b54-a0bf-43a8-a5bd-6a9e462ea7c7_fuels-dens_2100_000.png
12,175,0.35,1,1,116068,10410,126478,images/run_786b5248-04e2-4387-b640-d26107ff2f0d_fuels-dens_2100_000.png
12,175,0.35,1,1,101984,5801,107785,images/run_a1f6f301-2ba8-4cc2-83cb-c5f769bef03a_fuels-dens_2100_000.png
5,270,0.35,0,0,106285,0,106285,images/run_077d21e3-304f-47dd-b7af-5d0935459ce2_fuels-dens_2100_000.png
5,270,0.35,0,0,101922,1022,102944,images/run_ffef4161-9a62-48e2-a4c6-cccc946963df_fuels-dens_2100_000.png
3,270,0.35,0,0,101530,0,101530,images/run_df885d21-1e68-48a2-9fa1-46e27ce237ed_fuels-dens_2100_000.png
2,175,0.35,0,0,124241,781,125022,images/run_fa0c4812-83e8-4aa1-8d11-1f084210ebbf_fuels-dens_2100_000.png
3,175,0.35,0,0,105435,0,105435,images/run_541e97d1-18ff-483e-b493-2e4118be2214_fuels-dens_2100_000.png
2,175,0.35,0,0,123638,1353,124991,images/run_3e8d0609-0af0-417a-baa9-d34ca7ada941_fuels-dens_2100_000.png
2,175,0.35,0,0,103711,0,103711,images/run_680b9013-61fe-4220-b2d5-26368410a93c_fuels-dens_2100_000.png
8,175,0.35,1,1,105284,3579,108863,images/run_d2875987-f205-49a0-b320-6011393b9af6_fuels-dens_2100_000.png
8,175,0.35,1,1,120800,12066,132866,images/run_e21c766c-3722-4a08-9d82-d35753b59088_fuels-dens_2100_000.png
3,175,0.35,0,0,89475,2366,91841,images/run_e4395522-02fe-4db4-b0c0-605394ccd7d3_fuels-dens_2100_000.png
12,270,0.35,0,0,126316,1286,127602,images/run_30b4b12b-285c-4abc-98c9-b68f0e524dce_fuels-dens_2100_000.png
3,175,0.35,0,0,122602,1996,124598,images/run_8e17b84b-3741-4797-9955-19d6cf8aebf1_fuels-dens_2100_000.png
8,270,0.35,0,0,130823,0,130823,images/run_749bf19c-938d-4cbc-b430-af3578145845_fuels-dens_2100_000.png
8,270,0.35,0,0,120666,813,121479,images/run_aacbf827-fd38-4ca2-a461-80831ef7f996_fuels-dens_2100_000.png
8,270,0.35,1,0,106809,0,106809,images/run_eacf01bb-feaa-4908-83ee-e0b25bc72483_fuels-dens_2100_000.png
5,270,0.35,0,0,129262,0,129262,images/run_383e55f2-c440-43c8-9681-da084206f583_fuels-dens_2100_000.png
3,270,0.35,0,0,83242,0,83242,images/run_d4efb206-0778-4ff8-8eb8-8b4192620642_fuels-dens_2100_000.png
12,270,0.35,0,0,107999,0,107999,images/run_7561ca57-378a-4e3c-8321-c89e837b7e78_fuels-dens_2100_000.png
5,175,0.35,1,1,86377,6637,93014,images/run_df1e3572-969f-4718-a868-59bbd7eb555b_fuels-dens_2100_000.png
5,270,0.35,1,0,104122,0,104122,images/run_a8dd6f85-dd1d-4e2a-96f2-34665436b4ba_fuels-dens_2100_000.png
5,270,0.35,0,0,92160,700,92860,images/run_e713de58-2010-4182-98ff-e7c3a7a53543_fuels-dens_2100_000.png
5,270,0.35,0,0,124816,535,125351,images/run_0a188b73-84fe-47cd-805f-5e545d82266e_fuels-dens_2100_000.png
12,175,0.35,1,1,101907,6978,108885,images/run_d99effa7-82b0-4d41-8e0a-40ddbae10169_fuels-dens_2100_000.png
12,175,0.35,1,1,112852,19185,132037,images/run_02fe5fc7-8281-464b-af09-1502ed48d0f6_fuels-dens_2100_000.png
3,270,0.35,0,0,122245,635,122880,images/run_6890c02f-7d18-4db3-82da-c69d4d7d7c06_fuels-dens_2100_000.png
3,270,0.35,0,0,124432,275,124707,images/run_201e6eeb-ddcf-430c-aa44-67c4309f3118_fuels-dens_2100_000.png
3,270,0.35,0,0,89463,208,89671,images/run_33ed3937-102d-44f7-99cf-247ead547d85_fuels-dens_2100_000.png
3,270,0.35,0,0,104799,0,104799,images/run_03bc8c8e-8ea5-431e-beab-689dcef43588_fuels-dens_2100_000.png
12,175,0.35,1,1,118221,11990,130211,images/run_96ecc497-f4e0-44e4-adad-189fd95e6802_fuels-dens_2100_000.png
12,175,0.35,1,1,116188,13457,129645,images/run_2d45515a-035d-4a81-90dc-30477823d3fe_fuels-dens_2100_000.png
12,175,0.35,1,1,102159,9555,111714,images/run_6ca234e2-7b30-46fb-8f73-8fe265a8c28d_fuels-dens_2100_000.png
5,175,0.35,0,0,105892,654,106546,images/run_61bb21b9-7e7c-4779-8461-2b5e0c160121_fuels-dens_2100_000.png
8,175,0.35,1,1,92199,8806,101005,images/run_f8ba25e9-4043-4f44-bba8-09b760ccbcfb_fuels-dens_2100_000.png
12,175,0.35,1,1,103051,7269,110320,images/run_3d088616-52ec-4be1-b1f3-8f3f989b0a12_fuels-dens_2100_000.png
3,175,0.425,0,0,90765,0,90765,images/run_6e5ac844-7044-4dbd-ba33-8f1ea5630f9d_fuels-dens_2100_000.png
2,270,0.425,1,0,92737,0,92737,images/run_e3a91a18-cc44-4e9f-b79c-c3b0887caf9b_fuels-dens_2100_000.png
3,240,0.425,1,0,114771,561,115332,images/run_83f0ad93-81fe-476b-a5a8-d7dd77cbe1c7_fuels-dens_2100_000.png
3,195,0.425,1,0,111229,1305,112534,images/run_abe538f4-d218-41ae-900c-f9dbea2cdd55_fuels-dens_2100_000.png
3,225,0.425,0,0,93944,0,93944,images/run_a90f37e0-fd9d-4c25-bc8b-c752260d3b8b_fuels-dens_2100_000.png
3,225,0.425,1,0,112975,343,113318,images/run_a6624867-f1f2-401b-ae87-c1dcd647ee23_fuels-dens_2100_000.png
2,270,0.425,0,0,36917,0,36917,images/run_af27e078-6d78-4df0-bfce-f89d103e24a2_fuels-dens_2100_000.png
2,270,0.425,0,0,110365,70,110435,images/run_e1931e5b-816c-42a4-8787-50963f478a96_fuels-dens_2100_000.png
3,195,0.425,0,0,93220,0,93220,images/run_6cfd2df8-6d7a-442e-bc67-fa39018e6eab_fuels-dens_2100_000.png
3,225,0.425,0,0,28978,1888,30866,images/run_d171962d-af6c-4e2b-a6ac-ceff0e1a2006_fuels-dens_2100_000.png
3,195,0.425,0,0,37061,1854,38915,images/run_9563b158-2d4c-437a-93fb-843b1ddb287f_fuels-dens_2100_000.png
3,240,0.425,0,0,27019,540,27559,images/run_55dbe98c-9bff-4f3b-91c9-1bdbf2e4c958_fuels-dens_2100_000.png
3,240,0.425,0,0,91870,0,91870,images/run_f9c9516d-73d6-4f6e-b228-b05149c12229_fuels-dens_2100_000.png
3,255,0.425,0,0,114947,162,115109,images/run_55c2f9cd-8a78-4639-b9ad-4d0b68cd4050_fuels-dens_2100_000.png
2,255,0.425,0,0,28956,198,29154,images/run_700e84ab-1ed9-42c6-b899-391757436126_fuels-dens_2100_000.png
12,225,0.425,1,1,112760,32340,145100,images/run_71309d5a-d4e4-4305-a2dd-84f3f35c1d44_fuels-dens_2100_000.png
12,225,0.425,1,1,50674,36526,87200,images/run_a18b7a46-311b-4a39-aa94-bf7bf2129789_fuels-dens_2100_000.png
12,195,0.425,1,1,107316,17145,124461,images/run_3ab66407-7efd-4110-83c9-02027431e8ce_fuels-dens_2100_000.png
12,195,0.425,1,1,50742,26056,76798,images/run_be436c12-46c1-4024-9a30-ab5be537078c_fuels-dens_2100_000.png
12,195,0.425,1,1,99433,6447,105880,images/run_25e2aeb6-c085-45cb-821b-0ca99db052d0_fuels-dens_2100_000.png
12,180,0.425,1,1,59555,11175,70730,images/run_d3f85726-818f-480b-99d1-411820be45fb_fuels-dens_2100_000.png
12,180,0.425,1,1,94220,5891,100111,images/run_81a2c5f3-8f8a-408f-b552-db621ab159c5_fuels-dens_2100_000.png
12,175,0.425,1,1,103210,7854,111064,images/run_b6d1cbed-fb21-4bc9-b46c-52b91b1ed588_fuels-dens_2100_000.png
12,175,0.425,1,1,61322,14051,75373,images/run_2baf63f0-d7f2-45a9-a606-d76fd3611a7e_fuels-dens_2100_000.png
12,175,0.425,1,1,90793,4644,95437,images/run_3869155a-5f41-40f6-a717-5cd0714c27eb_fuels-dens_2100_000.png
12,240,0.425,1,1,102746,8310,111056,images/run_e50824b2-4da2-4699-af32-bcb530c3541e_fuels-dens_2100_000.png
8,270,0.425,0,0,115234,778,116012,images/run_b6873969-7f06-444a-97e2-c2bc2ff6fcdd_fuels-dens_2100_000.png
8,270,0.425,0,0,96592,0,96592,images/run_52e5f6cc-4451-43d4-87d2-4d237017fea0_fuels-dens_2100_000.png
5,175,0.425,0,0,92991,0,92991,images/run_5d3f0809-e118-41e8-819d-064981571eb3_fuels-dens_2100_000.png
5,175,0.425,0,0,113779,3869,117648,images/run_32253183-902c-4033-8447-8c556d5e002c_fuels-dens_2100_000.png
5,180,0.425,0,0,95294,301,95595,images/run_e5d2bd10-679d-4628-8052-cff152190959_fuels-dens_2100_000.png
5,180,0.425,1,1,52961,2919,55880,images/run_e55ad7b9-50b7-4158-8a0a-788a85ff850e_fuels-dens_2100_000.png
5,180,0.425,0,0,113582,2209,115791,images/run_7f4d57d9-7659-48d1-ac6f-a955ba0011ce_fuels-dens_2100_000.png
8,255,0.425,0,0,46125,4289,50414,images/run_4dc1e4f9-9abb-4d26-a042-0960e8689c6c_fuels-dens_2100_000.png
8,255,0.425,0,0,97103,0,97103,images/run_a0655f3e-6ed7-4167-ad0b-ecaa73af28fc_fuels-dens_2100_000.png
8,240,0.425,1,0,116477,5654,122131,images/run_2688926d-8f75-48b3-9ade-9d906db5d857_fuels-dens_2100_000.png
8,270,0.425,0,0,52095,948,53043,images/run_56e6b088-dd00-4d44-83e6-38505e7819ef_fuels-dens_2100_000.png
2,255,0.425,1,0,111135,0,111135,images/run_7d9dd5b5-f2d7-4ed1-bd8a-516ed6fe7274_fuels-dens_2100_000.png
12,240,0.425,1,1,68753,20043,88796,images/run_89424e2a-3eab-49e6-bc54-780d03bb19b1_fuels-dens_2100_000.png
12,255,0.425,1,0,100520,0,100520,images/run_aed88197-41a6-419a-b505-76697cbaab82_fuels-dens_2100_000.png
2,255,0.425,1,0,92118,0,92118,images/run_f28b51a8-f3d3-497e-b4cc-09ac812bea5a_fuels-dens_2100_000.png
2,240,0.425,1,0,110037,0,110037,images/run_1d1f102c-9333-4d29-812c-ba57b1811b91_fuels-dens_2100_000.png
2,240,0.425,0,0,27622,535,28157,images/run_8e6f46d5-be8e-4d26-961d-23a369a3ee85_fuels-dens_2100_000.png
2,240,0.425,0,0,92169,0,92169,images/run_5797f5b7-9b30-4183-8b2f-7c0d1df8a570_fuels-dens_2100_000.png
2,225,0.425,1,0,107899,373,108272,images/run_f168cc2e-a771-4630-b092-07b3351a988d_fuels-dens_2100_000.png
2,225,0.425,0,0,26175,163,26338,images/run_6b0ff2db-782a-4ab2-868f-aa0edd038898_fuels-dens_2100_000.png
2,195,0.425,1,0,108718,377,109095,images/run_0e130ece-31fa-49e7-8b47-d0f597710741_fuels-dens_2100_000.png
2,195,0.425,0,0,33347,592,33939,images/run_e9c975c6-3e2e-4081-ab92-e6a43bc1906b_fuels-dens_2100_000.png
2,180,0.425,0,0,108559,135,108694,images/run_1e802af9-afcf-4bde-af01-9290bf2fa1aa_fuels-dens_2100_000.png
2,180,0.425,0,0,40792,102,40894,images/run_f8aaac6e-bfad-43a8-920a-1172973e4198_fuels-dens_2100_000.png
12,240,0.425,1,1,115920,16724,132644,images/run_1cf0206d-f233-4f43-bada-d8df352cc363_fuels-dens_2100_000.png
2,180,0.425,0,0,89735,0,89735,images/run_2e6eb436-1322-476c-b0ec-484d43da78b0_fuels-dens_2100_000.png
2,175,0.425,0,0,46137,0,46137,images/run_d42a007e-08b3-41cf-a028-8d20f3e3e596_fuels-dens_2100_000.png
2,175,0.425,0,0,89355,0,89355,images/run_22979c75-e53d-4a45-8f18-08a19fea33c0_fuels-dens_2100_000.png
3,255,0.425,0,0,91047,0,91047,images/run_ab06f8a2-ecd0-4e95-b0e5-06276cbf6efa_fuels-dens_2100_000.png
3,255,0.425,0,0,27068,139,27207,images/run_1481a253-6bcc-481c-99f2-fb7284b53030_fuels-dens_2100_000.png
3,175,0.425,0,0,39530,421,39951,images/run_4bb7a586-d2a6-47b3-9bdd-acf47f90556d_fuels-dens_2100_000.png
12,270,0.425,0,0,66061,1116,67177,images/run_dd66c6f1-7763-4f4f-aff4-d0b9f1bdaf87_fuels-dens_2100_000.png
12,270,0.425,0,0,96162,0,96162,images/run_f0a5e570-a772-448b-b193-1bd497e81101_fuels-dens_2100_000.png
3,270,0.425,0,0,88312,0,88312,images/run_fad6761a-ca6c-412c-a1d0-28b807115153_fuels-dens_2100_000.png
3,270,0.425,0,0,38495,0,38495,images/run_129491d6-69e3-4f64-b9b6-c2073584b93e_fuels-dens_2100_000.png
3,270,0.425,0,0,114743,0,114743,images/run_d313c31a-563a-4a1e-9c49-21933594b7ef_fuels-dens_2100_000.png
12,255,0.425,1,1,115502,8269,123771,images/run_fc034a00-107c-4362-b1c7-ec2e533f0c59_fuels-dens_2100_000.png
2,175,0.425,1,0,110533,333,110866,images/run_39d8d008-3c2f-421d-8ac8-58ebd586a47e_fuels-dens_2100_000.png
3,175,0.425,0,0,109913,931,110844,images/run_e24637fe-bb1e-4ffc-9b11-214e10ede209_fuels-dens_2100_000.png
12,255,0.425,1,1,75518,9317,84835,images/run_287fcf8f-b443-4322-a235-72d8714f42a2_fuels-dens_2100_000.png
3,180,0.425,0,0,38104,792,38896,images/run_6243664f-e480-4e90-8501-a34bf47077c9_fuels-dens_2100_000.png
12,180,0.425,1,1,92687,5450,98137,images/run_2a2c72be-8f62-4129-84a3-b9ddb3348671_fuels-dens_2100_000.png
12,175,0.425,1,1,103363,7307,110670,images/run_fa7a5a7b-c9b2-4c6b-a209-9a6b2d088417_fuels-dens_2100_000.png
12,175,0.425,1,1,75962,7069,83031,images/run_e3e2f58e-2fff-4008-97f8-627d51ea0c65_fuels-dens_2100_000.png
12,175,0.425,1,1,91156,4708,95864,images/run_237765f5-c1f4-4151-a966-b607d986621d_fuels-dens_2100_000.png
2,195,0.425,0,0,91984,0,91984,images/run_ab1eb8cb-41d3-45b8-9ef6-bd3e3ea2ccf1_fuels-dens_2100_000.png
2,195,0.425,0,0,39824,310,40134,images/run_02a5f989-0517-4586-ab58-e6fba54ac361_fuels-dens_2100_000.png
2,195,0.425,0,0,110676,821,111497,images/run_5939521c-989e-49f3-baff-871232040025_fuels-dens_2100_000.png
2,225,0.425,0,0,91412,0,91412,images/run_c7248dcd-bd6e-4d90-98e8-abc228022c42_fuels-dens_2100_000.png
2,225,0.425,0,0,30079,298,30377,images/run_67146134-b1ff-4939-89c0-9f5e1002aa23_fuels-dens_2100_000.png
8,270,0.425,0,0,115638,0,115638,images/run_707aa9f5-c5c5-4eb6-a85d-07908ea81ce4_fuels-dens_2100_000.png
8,270,0.425,0,0,60694,808,61502,images/run_988221a0-1522-4e6b-83f1-de3f742cc933_fuels-dens_2100_000.png
8,270,0.425,0,0,96242,0,96242,images/run_9adc2a02-b6b4-4fbf-982b-0a55240005be_fuels-dens_2100_000.png
2,225,0.425,0,0,111520,345,111865,images/run_272e8e03-de11-4209-9a36-0e39a960ab5d_fuels-dens_2100_000.png
2,240,0.425,0,0,92006,0,92006,images/run_02d09e4b-696a-46ba-b3e6-75e665aca851_fuels-dens_2100_000.png
2,240,0.425,0,0,30091,28,30119,images/run_571cb02f-3e11-46d3-b849-85a0cf2e11ae_fuels-dens_2100_000.png
2,240,0.425,0,0,111504,401,111905,images/run_a242100c-d1f2-4c11-9589-a1cdff410940_fuels-dens_2100_000.png
8,255,0.425,0,0,118833,1944,120777,images/run_f821bae3-e3fa-4349-ae4c-7f59beb720d8_fuels-dens_2100_000.png
8,255,0.425,1,1,51181,4473,55654,images/run_48801d8d-7fc8-4731-a053-9648d953a52b_fuels-dens_2100_000.png
8,255,0.425,0,0,95605,0,95605,images/run_b2b7a7ba-0afc-4e01-8e5c-8f79a7f3a26a_fuels-dens_2100_000.png
8,240,0.425,1,1,116574,8641,125215,images/run_3690c2cf-f93a-45fb-9b1b-36956da6f8a5_fuels-dens_2100_000.png
8,240,0.425,1,1,35311,8807,44118,images/run_f320d79c-94fc-413a-b8fe-afa804cc146e_fuels-dens_2100_000.png
8,240,0.425,0,0,100278,2709,102987,images/run_6482d5f8-3087-4b53-8ee8-6a60a63822cd_fuels-dens_2100_000.png
8,225,0.425,1,1,114965,15966,130931,images/run_751868e9-7521-48cb-928e-47f574099341_fuels-dens_2100_000.png
8,225,0.425,1,1,37000,17753,54753,images/run_a00d9044-ea06-4c34-a488-5efdca13c6ad_fuels-dens_2100_000.png
8,225,0.425,1,1,103513,2962,106475,images/run_b2267e65-836b-440a-b417-5c78d4a88be1_fuels-dens_2100_000.png
12,180,0.425,1,1,66069,5331,71400,images/run_66858aa7-5f09-4946-9707-c9b5ac8ef017_fuels-dens_2100_000.png
12,180,0.425,1,1,106889,7167,114056,images/run_5658c0ce-531c-4933-a63e-3f0a5171a773_fuels-dens_2100_000.png
12,195,0.425,1,1,98108,7241,105349,images/run_99ecdd1a-3f9f-4206-8b6f-53c4272659e8_fuels-dens_2100_000.png
12,195,0.425,1,1,52145,21951,74096,images/run_2d6f1d6c-5e34-4db3-a01f-d957fa923345_fuels-dens_2100_000.png
2,195,0.425,0,0,90690,0,90690,images/run_9ac2f721-6c65-4f2c-8827-7bc49c01c8d7_fuels-dens_2100_000.png
12,270,0.425,0,0,113452,1757,115209,images/run_1f541b5e-5524-4b59-830e-014d1fa72465_fuels-dens_2100_000.png
12,225,0.425,1,1,104906,7726,112632,images/run_3b5dea19-0eac-4fa7-b415-56fbfe5ca6ec_fuels-dens_2100_000.png
3,195,0.425,0,0,110077,1309,111386,images/run_4ece8e71-ca22-4a24-9adc-681d95491104_fuels-dens_2100_000.png
12,270,0.425,0,0,97080,0,97080,images/run_f21c0db1-90ef-4c82-8edb-e7b28061ed0f_fuels-dens_2100_000.png
12,180,0.425,1,1,78285,6690,84975,images/run_e97bcaf0-7d0a-4b2e-9bff-00c1fecb99c9_fuels-dens_2100_000.png
2,175,0.425,0,0,90637,0,90637,images/run_1c222ceb-8a7d-4941-967a-d6505463a105_fuels-dens_2100_000.png
5,255,0.425,0,0,118813,245,119058,images/run_7c3fb0f7-2910-45b8-bf27-9b2e50ba7029_fuels-dens_2100_000.png
2,175,0.425,0,0,48085,767,48852,images/run_3417bb6a-4e5a-4da6-aa01-08192e428d01_fuels-dens_2100_000.png
2,175,0.425,0,0,111759,409,112168,images/run_b9e469a0-9f74-4dd1-b43c-0b023a8d309a_fuels-dens_2100_000.png
12,270,0.425,0,0,114142,49,114191,images/run_c24ecbf9-3cfc-4c3a-8c7c-b291b1c63c29_fuels-dens_2100_000.png
12,270,0.425,1,1,76462,9575,86037,images/run_73c9414f-eca5-480d-981c-cd5252608bf7_fuels-dens_2100_000.png
8,195,0.425,1,1,111102,12540,123642,images/run_211533c0-4774-46be-996e-3753b1aae139_fuels-dens_2100_000.png
12,270,0.425,0,0,94806,0,94806,images/run_4cff246f-01f6-4bd4-99fd-c33617ca54a6_fuels-dens_2100_000.png
2,180,0.425,0,0,47772,200,47972,images/run_b4324e8a-74c3-4d7c-b6ee-36c36a12aff9_fuels-dens_2100_000.png
2,180,0.425,0,0,112926,709,113635,images/run_6be6fa1c-75b9-428e-b5c3-2abd7edaab94_fuels-dens_2100_000.png
12,255,0.425,1,1,113059,11668,124727,images/run_2dbb920e-b203-42d5-9c49-45f14be79413_fuels-dens_2100_000.png
12,255,0.425,1,1,63690,8374,72064,images/run_8f1c1ae0-0645-43d5-8cfc-ce70305ee421_fuels-dens_2100_000.png
12,255,0.425,1,1,99857,4723,104580,images/run_d072f272-e66b-43ba-83a3-cce5a40dcde8_fuels-dens_2100_000.png
12,240,0.425,1,1,114343,12805,127148,images/run_38967a6d-375b-4e41-8591-e2f396d41241_fuels-dens_2100_000.png
12,240,0.425,1,1,56793,15127,71920,images/run_1c9bc308-6fdd-4d2e-a4f2-47d6ae7a446e_fuels-dens_2100_000.png
12,240,0.425,1,1,102088,5363,107451,images/run_1bc2270d-e042-49e7-a076-7e8811c64e80_fuels-dens_2100_000.png
12,225,0.425,1,1,112902,29889,142791,images/run_1f7ad830-8575-4fc4-8db2-840fb7f1834a_fuels-dens_2100_000.png
12,225,0.425,1,1,38386,37340,75726,images/run_52346b2e-5d67-408e-98b0-fbb0c4227d73_fuels-dens_2100_000.png
12,225,0.425,1,1,103381,13172,116553,images/run_29bbef9f-4f9a-4e4f-a830-7e6bfd28c2d5_fuels-dens_2100_000.png
12,195,0.425,1,1,108734,11050,119784,images/run_bccd7e72-417e-4cab-9173-5487d2cd0747_fuels-dens_2100_000.png
2,180,0.425,0,0,90034,0,90034,images/run_44214cef-827b-4aec-9e01-3982c75921ad_fuels-dens_2100_000.png
3,180,0.425,0,0,91166,0,91166,images/run_f378a79a-6107-42f0-a1cb-af2e2d5f9bb7_fuels-dens_2100_000.png
8,195,0.425,1,1,45604,8540,54144,images/run_d942877a-87d6-4cd0-83b3-27e06f0993b1_fuels-dens_2100_000.png
8,180,0.425,1,1,108235,6575,114810,images/run_a9ebcada-8687-4d69-a505-b974191f404f_fuels-dens_2100_000.png
5,175,0.425,0,0,47403,1304,48707,images/run_1af99b38-1743-4573-8808-60aaac9dd49e_fuels-dens_2100_000.png
5,175,0.425,0,0,92014,166,92180,images/run_faa2b452-c39c-4e32-9925-7052298514a3_fuels-dens_2100_000.png
8,240,0.425,1,1,48309,9667,57976,images/run_3d8d3c1e-f9a0-4f81-a3f6-c06db3022a0a_fuels-dens_2100_000.png
3,175,0.425,0,0,91832,0,91832,images/run_ecc63905-e11a-446a-9955-78dd2ab81088_fuels-dens_2100_000.png
3,175,0.425,0,0,44771,880,45651,images/run_ef527acc-122b-4916-8cc6-431e972c2818_fuels-dens_2100_000.png
3,270,0.425,0,0,110792,0,110792,images/run_35eaccc9-0ebd-4342-806c-62a3974b36c6_fuels-dens_2100_000.png
3,270,0.425,0,0,34132,177,34309,images/run_3e4bd6fa-43ef-4fce-ab51-527f1c236b2a_fuels-dens_2100_000.png
3,270,0.425,0,0,89072,0,89072,images/run_8f362ca1-ceaf-47cc-9c16-773b9f85e5fa_fuels-dens_2100_000.png
3,175,0.425,0,0,112756,1142,113898,images/run_9987ecf9-a217-47b8-a0ea-6d6d9763a740_fuels-dens_2100_000.png
3,180,0.425,0,0,92806,0,92806,images/run_8f48f02f-5d79-4e8e-a977-e63ff4186ed6_fuels-dens_2100_000.png
3,180,0.425,0,0,46996,953,47949,images/run_b0de6697-1440-4c4e-909f-0b816c5d8941_fuels-dens_2100_000.png
3,180,0.425,0,0,112697,868,113565,images/run_89605685-cb91-4358-8145-2017d1f315c7_fuels-dens_2100_000.png
3,255,0.425,0,0,112990,0,112990,images/run_ca38e32f-6977-41b5-bc00-e5ff6b8bc103_fuels-dens_2100_000.png
3,255,0.425,0,0,26060,681,26741,images/run_e1fbde6f-6fd5-42c0-8eb3-cc3ce4ddeebc_fuels-dens_2100_000.png
3,255,0.425,0,0,91100,0,91100,images/run_518e55b6-924f-4891-9fbc-61d8e43c6f07_fuels-dens_2100_000.png
3,240,0.425,0,0,112481,1092,113573,images/run_6748cf97-4144-4aa9-ad15-3ba31190c7c2_fuels-dens_2100_000.png
3,240,0.425,0,0,26653,636,27289,images/run_88ac448b-379b-49fd-a637-a1fcee221720_fuels-dens_2100_000.png
3,240,0.425,0,0,92417,0,92417,images/run_805153e3-ad80-4168-93a3-97065fa82e83_fuels-dens_2100_000.png
3,225,0.425,0,0,111229,457,111686,images/run_6d6facb5-e2cc-4159-a8db-f689072d09d4_fuels-dens_2100_000.png
3,225,0.425,0,0,26664,1256,27920,images/run_53591222-1627-4c7e-879e-239a4482eff7_fuels-dens_2100_000.png
3,225,0.425,0,0,93043,0,93043,images/run_94a041a0-b26a-4b91-bd01-30f4f4d618e0_fuels-dens_2100_000.png
3,195,0.425,0,0,111072,1335,112407,images/run_ccb2a95e-b6df-470f-858d-af2473ea012c_fuels-dens_2100_000.png
3,195,0.425,0,0,35765,1227,36992,images/run_b49b7949-9db2-4fbd-93e6-0a09fd396c10_fuels-dens_2100_000.png
3,195,0.425,0,0,92810,0,92810,images/run_7b6b5ecc-913a-4cf4-bdf7-d201e6040d33_fuels-dens_2100_000.png
3,180,0.425,0,0,111125,1258,112383,images/run_f95f801b-afdc-4bbd-8fa6-b11bf666e764_fuels-dens_2100_000.png
5,180,0.425,0,0,94052,137,94189,images/run_d4809308-73e7-4d26-85e8-0fa5c5c663c6_fuels-dens_2100_000.png
5,180,0.425,1,1,48869,2174,51043,images/run_b613a47c-29ba-4943-9640-5f56016c5173_fuels-dens_2100_000.png
5,180,0.425,0,0,110842,1998,112840,images/run_edefe4ae-a782-4e12-8e7c-da3029a7abd3_fuels-dens_2100_000.png
8,180,0.425,1,1,52979,4911,57890,images/run_8ca9edc4-c037-4fae-ba28-314bc82776de_fuels-dens_2100_000.png
8,180,0.425,1,1,95715,1681,97396,images/run_2945274d-6c6f-413f-b1b3-23b1920153fc_fuels-dens_2100_000.png
8,175,0.425,1,1,108467,7418,115885,images/run_4c10a11d-ab1d-4482-a554-23be3ebfd5cc_fuels-dens_2100_000.png
8,175,0.425,1,1,55545,3904,59449,images/run_9b3f6219-77ca-46d0-a4a8-1f877689ca7c_fuels-dens_2100_000.png
8,175,0.425,0,0,94331,1981,96312,images/run_4442e664-2cb2-4fe8-b303-2a872b23c497_fuels-dens_2100_000.png
2,255,0.425,0,0,92006,0,92006,images/run_fa7cabcd-b12d-4242-8a12-d16f2e0f18f3_fuels-dens_2100_000.png
2,255,0.425,0,0,34982,394,35376,images/run_fa9431a0-c7e3-4cc7-846d-2672145bdc3e_fuels-dens_2100_000.png
2,255,0.425,0,0,112865,0,112865,images/run_73c529fa-afde-42cf-bb8e-2ae1f57309da_fuels-dens_2100_000.png
5,270,0.425,0,0,113221,0,113221,images/run_3f941683-a687-427e-889b-e76063e1b4db_fuels-dens_2100_000.png
5,270,0.425,0,0,42047,0,42047,images/run_4e64a73f-b977-4443-a910-00ba201c2e84_fuels-dens_2100_000.png
5,270,0.425,0,0,87556,0,87556,images/run_23120efe-fcf4-48be-8414-a8e84c0adc20_fuels-dens_2100_000.png
2,270,0.425,0,0,90371,0,90371,images/run_69b851ba-bad4-49d9-93cd-145446befe4e_fuels-dens_2100_000.png
8,195,0.425,1,1,99573,2239,101812,images/run_2e03aa66-8525-4a3d-a0f7-42c20efde027_fuels-dens_2100_000.png
2,270,0.425,0,0,41907,0,41907,images/run_e5a28631-70a9-4f33-837a-2f5dbd957a04_fuels-dens_2100_000.png
5,255,0.425,0,0,114814,460,115274,images/run_26910a8c-fae5-451d-a95a-46e75ab50594_fuels-dens_2100_000.png
5,255,0.425,0,0,35480,3110,38590,images/run_159d9b3d-6840-4b64-a887-61358be7975c_fuels-dens_2100_000.png
5,255,0.425,0,0,89935,0,89935,images/run_e325de27-9160-4c94-8931-dc27e9b5a58b_fuels-dens_2100_000.png
5,240,0.425,0,0,116787,1492,118279,images/run_93063d71-ea85-4c91-b05c-85066fef2e45_fuels-dens_2100_000.png
5,240,0.425,1,0,35636,2902,38538,images/run_3e0b95a5-36ce-4ad9-8277-cbcca3ef9c0a_fuels-dens_2100_000.png
5,240,0.425,0,0,96600,0,96600,images/run_8aad7807-b69b-4ca7-b138-59c280e19e48_fuels-dens_2100_000.png
5,225,0.425,1,1,113994,3630,117624,images/run_7402b29c-4622-49dd-ac33-fa46f34c27e1_fuels-dens_2100_000.png
5,225,0.425,1,0,34145,3185,37330,images/run_a8cb5497-abb5-4ef1-921b-e32cd09d464d_fuels-dens_2100_000.png
5,225,0.425,0,0,98453,0,98453,images/run_50f713ef-456d-46eb-a88a-b4d96af2cac6_fuels-dens_2100_000.png
5,195,0.425,0,0,112537,3430,115967,images/run_64ce3a13-d049-4c86-ab50-dc0fa779a5f9_fuels-dens_2100_000.png
5,195,0.425,1,1,42569,3402,45971,images/run_990e4447-a181-42d7-ad67-59cfea38b5b9_fuels-dens_2100_000.png
5,195,0.425,0,0,96585,482,97067,images/run_310396d7-3f00-40ef-a1c1-f3ed4b9ff288_fuels-dens_2100_000.png
2,270,0.425,0,0,113150,0,113150,images/run_4cb3c309-402b-4ffe-8940-dec45761b1d7_fuels-dens_2100_000.png
8,240,0.425,0,0,101577,696,102273,images/run_bfcdb7e0-60d4-4767-8685-fb632fee55ed_fuels-dens_2100_000.png
5,255,0.425,0,0,115654,177,115831,images/run_d73f5e54-f3ce-4c61-9513-49baefe48cfe_fuels-dens_2100_000.png
3,180,0.425,0,0,89986,0,89986,images/run_c6d5e6cb-b9f0-4a42-94bf-a0606e6138af_fuels-dens_2100_000.png
3,195,0.425,0,0,92085,0,92085,images/run_7739e725-7775-4674-86a0-b7e79ff43563_fuels-dens_2100_000.png
5,225,0.425,1,1,32705,5922,38627,images/run_a36aff04-f226-49e4-aed3-093db4e356eb_fuels-dens_2100_000.png
5,225,0.425,0,0,99290,216,99506,images/run_de3a489a-a12e-4acc-9745-27afccd4ebe5_fuels-dens_2100_000.png
3,195,0.425,0,0,35780,732,36512,images/run_083d9f32-80ef-45d0-ba61-9b3a7a6e5a62_fuels-dens_2100_000.png
2,195,0.425,0,0,108777,700,109477,images/run_d2c42665-1be6-4db2-bb4a-2195139b5166_fuels-dens_2100_000.png
5,195,0.425,0,0,112282,4317,116599,images/run_07a1ac75-3023-4586-8f5d-ac3ee6acee2a_fuels-dens_2100_000.png
5,225,0.425,0,0,113712,3201,116913,images/run_18ef55f3-2c9d-44e7-9c6d-e6839ef7d89b_fuels-dens_2100_000.png
2,195,0.425,0,0,34359,396,34755,images/run_1a8c8037-def9-4de3-8519-4724736fffbf_fuels-dens_2100_000.png
12,255,0.425,0,0,97436,0,97436,images/run_0a9d6409-4851-49cc-a1d6-83951669c141_fuels-dens_2100_000.png
5,195,0.425,1,0,40326,1386,41712,images/run_92a9d098-40cf-4541-b4cb-3da1f50c6d60_fuels-dens_2100_000.png
5,195,0.425,0,0,96401,131,96532,images/run_82bebbfe-0f62-44c3-849c-98661c0d0344_fuels-dens_2100_000.png
12,255,0.425,1,1,74572,7096,81668,images/run_1e68beed-bbf2-413d-bf8e-dbd56ed58200_fuels-dens_2100_000.png
12,255,0.425,1,1,119182,10767,129949,images/run_36dd40c8-0c5d-414b-8924-26122c87d159_fuels-dens_2100_000.png
8,240,0.425,0,0,100442,747,101189,images/run_3bd394c9-6bf1-4462-9aa0-d6629999b7ef_fuels-dens_2100_000.png
2,195,0.425,0,0,90696,0,90696,images/run_bd043223-7080-409e-a25f-58f0d5105878_fuels-dens_2100_000.png
2,225,0.425,0,0,30090,350,30440,images/run_b767d4d0-bb43-4621-b258-c850531db4f4_fuels-dens_2100_000.png
12,225,0.425,1,1,104188,7367,111555,images/run_267d541d-a56f-4eef-80f6-7b46e07f07c5_fuels-dens_2100_000.png
12,225,0.425,1,1,78310,27009,105319,images/run_e878add9-7f09-4a67-83f6-5b31019e9909_fuels-dens_2100_000.png
2,225,0.425,0,0,92191,0,92191,images/run_ed08ed48-3d67-4e0b-8fda-380ebd153f5f_fuels-dens_2100_000.png
5,240,0.425,0,0,37690,572,38262,images/run_52e44e79-026f-4223-ba64-1ddaaa3b8330_fuels-dens_2100_000.png
12,225,0.425,1,1,117365,28631,145996,images/run_97c08099-96d7-4662-a460-0896a2062d26_fuels-dens_2100_000.png
12,240,0.425,1,1,72079,17186,89265,images/run_d27d1f3a-31f5-406e-94b6-086fec885329_fuels-dens_2100_000.png
5,255,0.425,0,0,32404,996,33400,images/run_d2ee0e5d-6480-4ce6-99f1-e621a9958e93_fuels-dens_2100_000.png
3,180,0.425,0,0,41771,569,42340,images/run_0339acc2-3eb4-4b61-b050-4c73d50ead4a_fuels-dens_2100_000.png
3,180,0.425,0,0,110244,863,111107,images/run_b2b27ad5-a340-4550-bb0f-3ec6211be90d_fuels-dens_2100_000.png
5,240,0.425,0,0,114895,1554,116449,images/run_904f0975-49f1-4bf1-8967-e5d7a9b80d25_fuels-dens_2100_000.png
5,240,0.425,0,0,31218,2888,34106,images/run_6689dda2-d1fe-43ce-bcb0-c01354ef7a17_fuels-dens_2100_000.png
5,255,0.425,0,0,89000,0,89000,images/run_7fa5b47e-92f7-44e9-87fe-b183052e7054_fuels-dens_2100_000.png
2,225,0.425,0,0,108764,720,109484,images/run_4dfeec34-1a34-4eff-9436-a2b26fb6c415_fuels-dens_2100_000.png
2,180,0.425,0,0,108465,372,108837,images/run_2c8bf38f-41f7-4b3f-8a67-46f62e7c9824_fuels-dens_2100_000.png
5,180,0.425,1,1,46640,4130,50770,images/run_43e0d353-c086-4c4e-908d-37acd82a21bd_fuels-dens_2100_000.png
5,255,0.425,0,0,41028,436,41464,images/run_351212c2-5b7a-473b-a8d5-93da52ea86b3_fuels-dens_2100_000.png
2,175,0.425,0,0,109611,528,110139,images/run_9ab75b40-7f36-4b56-8a96-06362de1183f_fuels-dens_2100_000.png
2,175,0.425,0,0,45633,209,45842,images/run_e45dbe3c-2141-49f3-be54-1f534403b472_fuels-dens_2100_000.png
2,175,0.425,0,0,87755,0,87755,images/run_acbd5cc6-b413-4a6e-8e78-e0cad754d557_fuels-dens_2100_000.png
8,195,0.425,1,1,114306,7402,121708,images/run_273fbd19-9d06-4a55-a467-26ff8c61053f_fuels-dens_2100_000.png
8,195,0.425,1,1,49692,8826,58518,images/run_36dcdce4-c2a7-46c2-b9b1-841298a44627_fuels-dens_2100_000.png
5,255,0.425,0,0,88998,0,88998,images/run_4918467d-33b4-4fa1-a8ce-24c9a91d9715_fuels-dens_2100_000.png
3,255,0.425,0,0,90086,0,90086,images/run_06d48e76-db94-420f-b6e4-069b6ac6284a_fuels-dens_2100_000.png
8,180,0.425,1,1,61412,7707,69119,images/run_dc3e2e6c-0665-41d6-806a-afb474aa39c9_fuels-dens_2100_000.png
3,270,0.425,0,0,111030,0,111030,images/run_e0894bbf-2037-464d-b8e9-fcc25afb8770_fuels-dens_2100_000.png
3,270,0.425,0,0,33619,0,33619,images/run_c7f78d08-e774-463a-922c-211a52245766_fuels-dens_2100_000.png
3,270,0.425,0,0,89981,0,89981,images/run_0a9d892d-20f9-43ac-8a26-38ba8f6fa057_fuels-dens_2100_000.png
8,180,0.425,1,1,112187,7536,119723,images/run_4477acd9-7245-4801-b7d9-ff9e7a2f51ce_fuels-dens_2100_000.png
5,270,0.425,0,0,88141,0,88141,images/run_5065659d-bd1b-421d-aad0-ee6264db313b_fuels-dens_2100_000.png
8,195,0.425,1,1,98286,4050,102336,images/run_971237ab-8d00-42e8-8ec6-5abd96e63ae3_fuels-dens_2100_000.png
5,180,0.425,0,0,110936,4604,115540,images/run_55377f74-03a4-4c3d-a8ec-dc26a5249213_fuels-dens_2100_000.png
3,240,0.425,0,0,111635,368,112003,images/run_36258ef4-9c3c-4bc4-bfe5-9f1840eef891_fuels-dens_2100_000.png
3,240,0.425,0,0,90556,0,90556,images/run_0d8308d9-ee07-454b-b4b7-5b343a298714_fuels-dens_2100_000.png
5,180,0.425,0,0,93214,0,93214,images/run_3bbc2cde-d982-4ff3-85b4-b2397f712390_fuels-dens_2100_000.png
2,180,0.425,0,0,41762,425,42187,images/run_5050525f-2965-49b1-b74a-1dce866abfad_fuels-dens_2100_000.png
3,225,0.425,0,0,29432,2073,31505,images/run_419fafec-f4bc-4ceb-bc4b-8545b538b1b5_fuels-dens_2100_000.png
3,225,0.425,0,0,111385,519,111904,images/run_a2428358-e379-4265-b2f6-11dec6e7d2c5_fuels-dens_2100_000.png
2,180,0.425,0,0,87758,0,87758,images/run_06778665-e2ab-408b-aa16-a40ded592814_fuels-dens_2100_000.png
3,240,0.425,0,0,27631,1125,28756,images/run_a98bd726-3b34-489c-a2c2-d765364b0608_fuels-dens_2100_000.png
8,225,0.425,1,1,52220,10811,63031,images/run_9786964f-19de-483d-87e2-e119629feb9c_fuels-dens_2100_000.png
5,175,0.425,0,0,109757,3157,112914,images/run_11daaec7-4e33-4738-ac74-b294285094b3_fuels-dens_2100_000.png
5,175,0.425,0,0,48479,3332,51811,images/run_70497130-8a17-4948-a8da-99ca529bbdbc_fuels-dens_2100_000.png
5,175,0.425,0,0,91760,495,92255,images/run_72bc2993-1453-4527-a93c-65210f95d1f8_fuels-dens_2100_000.png
12,270,0.425,1,0,81344,1,81345,images/run_bd9f099f-7112-4e70-b76d-bd2d38681f3e_fuels-dens_2100_000.png
12,270,0.425,0,0,116456,0,116456,images/run_ecfff243-dda5-4656-9432-4120b3627321_fuels-dens_2100_000.png
5,240,0.425,0,0,118516,1952,120468,images/run_b002b2f8-5b5c-4be0-9b89-86b4a49fbabd_fuels-dens_2100_000.png
8,225,0.425,1,1,103164,3319,106483,images/run_b19ee4f1-627b-4ea3-88e2-9a53d9124623_fuels-dens_2100_000.png
5,240,0.425,0,0,94953,0,94953,images/run_63b0eeed-b15c-4be9-a657-bf3950fbea98_fuels-dens_2100_000.png
3,255,0.425,0,0,111400,344,111744,images/run_35776bb7-9716-4c41-8797-b34121186951_fuels-dens_2100_000.png
3,175,0.425,0,0,110108,1226,111334,images/run_322d5316-05ad-434a-b866-b1fb39240a1a_fuels-dens_2100_000.png
8,180,0.425,1,1,110018,7843,117861,images/run_0806495c-6b4f-485f-bb63-ad05c9cc7d99_fuels-dens_2100_000.png
8,180,0.425,1,1,49169,8275,57444,images/run_75d5178a-cb49-423a-99a0-a1571a911777_fuels-dens_2100_000.png
8,240,0.425,0,0,121033,7017,128050,images/run_e59effac-ae4f-4fbd-83c5-feac171c02f2_fuels-dens_2100_000.png
8,240,0.425,1,0,51418,2911,54329,images/run_173d4ff0-760d-438e-b7f1-d28dbbfb842b_fuels-dens_2100_000.png
12,175,0.425,1,1,91425,5233,96658,images/run_b8d8cdff-f4b7-4bbe-bd66-0b0ad42ac25f_fuels-dens_2100_000.png
8,175,0.425,1,1,62043,4162,66205,images/run_ce3739e6-62aa-4096-bf43-780ed55f8529_fuels-dens_2100_000.png
12,175,0.425,1,1,87855,15316,103171,images/run_bda67b72-f4fd-484a-87fb-ef19271c1de6_fuels-dens_2100_000.png
8,175,0.425,1,0,56347,6165,62512,images/run_f9c97be9-9a75-45dc-aabd-c4a3d2a8e56f_fuels-dens_2100_000.png
8,175,0.425,0,0,93584,1604,95188,images/run_cdf02aa8-2d72-453b-98e1-2332b5202a9b_fuels-dens_2100_000.png
8,175,0.425,0,0,94296,1516,95812,images/run_a1682ff4-4466-49d4-a05c-4b4f91a66f4e_fuels-dens_2100_000.png
2,270,0.425,0,0,90655,0,90655,images/run_2bd4e209-e775-44d6-9972-0765568b61fb_fuels-dens_2100_000.png
5,195,0.425,0,0,98274,0,98274,images/run_a4b04dee-53d7-4788-ad3d-8b4b873f07ca_fuels-dens_2100_000.png
5,195,0.425,0,1,43031,3575,46606,images/run_490a0e96-6c0d-4007-9e44-59cf3c5be031_fuels-dens_2100_000.png
8,175,0.425,1,1,108552,6969,115521,images/run_a5ea0ce4-d11e-4031-9bc6-33d6ed480eb8_fuels-dens_2100_000.png
5,195,0.425,0,0,114885,2458,117343,images/run_669048c9-b3a4-4838-898d-1e5f807cc2db_fuels-dens_2100_000.png
8,175,0.425,1,1,111111,6808,117919,images/run_96a4a32f-a2cc-4858-a78e-acd2d6a468b6_fuels-dens_2100_000.png
8,195,0.425,0,0,99181,1673,100854,images/run_51812454-3f29-4da5-91c4-93b1eedd54ee_fuels-dens_2100_000.png
8,225,0.425,1,1,115866,11619,127485,images/run_9eddd86f-c620-4108-8a1b-6daad65b83a6_fuels-dens_2100_000.png
8,225,0.425,1,1,41581,17433,59014,images/run_cf5d6c66-f66a-4e66-a096-7056c14d9e9b_fuels-dens_2100_000.png
8,180,0.425,0,0,95259,1824,97083,images/run_f5a0eabc-c9e8-471f-92e8-f2871e6f4808_fuels-dens_2100_000.png
8,270,0.425,0,0,96556,0,96556,images/run_78098f8f-a129-4848-aa85-a9f79ef0dca2_fuels-dens_2100_000.png
8,270,0.425,0,0,57841,433,58274,images/run_e340855a-c556-4ce8-8521-9efbb4e8de70_fuels-dens_2100_000.png
8,225,0.425,0,0,103686,1171,104857,images/run_0ec2f182-1953-4bd5-aa8e-48277c865d94_fuels-dens_2100_000.png
2,255,0.425,0,0,92780,0,92780,images/run_33ea6e34-fa52-4a78-b4dc-bbcd108dd148_fuels-dens_2100_000.png
8,270,0.425,0,0,119420,377,119797,images/run_f609ac52-ddc9-4d54-bbfa-7b63d26e2f97_fuels-dens_2100_000.png
2,255,0.425,0,0,33263,276,33539,images/run_4fe24768-96ac-42f7-9746-2df93157da4d_fuels-dens_2100_000.png
8,195,0.425,1,1,110825,11277,122102,images/run_f784c689-e3f1-47c4-afc8-06bb3784f475_fuels-dens_2100_000.png
8,195,0.425,1,1,41654,15096,56750,images/run_0b44b1bb-b357-4e56-8361-129995e70f85_fuels-dens_2100_000.png
8,255,0.425,0,0,122421,501,122922,images/run_bf347d8f-68fd-4bf3-8e5f-6870aba214ae_fuels-dens_2100_000.png
8,255,0.425,0,0,58939,0,58939,images/run_f1906f7e-603c-4212-8c70-26c82ad7ebb3_fuels-dens_2100_000.png
8,255,0.425,0,0,95958,0,95958,images/run_6a0538ba-38c6-40f5-9d4a-c085fa28e17e_fuels-dens_2100_000.png
2,255,0.425,0,0,109015,152,109167,images/run_a90adf42-c3c1-431e-9b55-b4e7b119cd7c_fuels-dens_2100_000.png
2,270,0.425,0,0,40425,0,40425,images/run_80ec1d93-ad07-4102-ba6d-f11879b77374_fuels-dens_2100_000.png
12,175,0.425,1,1,107455,9338,116793,images/run_3d9e8d06-cf41-4106-abc7-fd398db9532c_fuels-dens_2100_000.png
2,240,0.425,0,0,91499,0,91499,images/run_bd4d6a32-8253-4ff3-89c4-9a9ab4aa3311_fuels-dens_2100_000.png
5,270,0.425,0,0,45100,0,45100,images/run_6054f78c-386c-4509-92d1-fb8dca3d61fb_fuels-dens_2100_000.png
5,270,0.425,0,0,112513,0,112513,images/run_98128b8b-009a-4856-95c6-4a75d64294d5_fuels-dens_2100_000.png
5,270,0.425,0,0,40399,0,40399,images/run_f92bcf66-187d-484c-b8cc-eeefad8d6011_fuels-dens_2100_000.png
2,240,0.425,0,0,29275,132,29407,images/run_ca628d95-12e7-44f0-92a8-557151d3a756_fuels-dens_2100_000.png
12,195,0.425,1,1,98401,8198,106599,images/run_436870f9-557c-4087-8209-3a7dd490441d_fuels-dens_2100_000.png
2,240,0.425,0,0,109479,98,109577,images/run_9f66039d-6ae0-4a25-937e-6a1a8a97c482_fuels-dens_2100_000.png
5,225,0.425,0,0,98163,0,98163,images/run_216a79f9-2c7d-4798-880f-bc337818ee46_fuels-dens_2100_000.png
5,270,0.425,0,0,87895,0,87895,images/run_629c67da-b125-43c1-abf3-f018006036b1_fuels-dens_2100_000.png
5,270,0.425,0,0,115813,0,115813,images/run_61da84a8-54d3-4499-81b8-4890d94aea19_fuels-dens_2100_000.png
12,195,0.425,1,1,52320,26545,78865,images/run_3eacfc5a-5b3a-4112-a12a-71cac69cc6ce_fuels-dens_2100_000.png
5,225,0.425,0,0,41935,1372,43307,images/run_1c8856a3-9c8d-49f3-a3d3-d3a2d77f0110_fuels-dens_2100_000.png
2,270,0.425,0,0,109607,0,109607,images/run_0fe33abc-59b7-43f7-824c-0a7bae81f7db_fuels-dens_2100_000.png
5,225,0.425,0,0,118270,3339,121609,images/run_ef9ce74b-963b-48b9-b8c0-71a566d071f7_fuels-dens_2100_000.png
12,195,0.425,1,1,110853,14612,125465,images/run_2b691d45-7adf-406c-8d44-bffbec2902df_fuels-dens_2100_000.png
3,175,0.425,0,0,89954,0,89954,images/run_15fd972f-49e7-4ce3-b387-cc96c9e3a0ee_fuels-dens_2100_000.png
3,175,0.425,0,0,41552,1042,42594,images/run_e3739e7d-3b4a-4785-aa85-fe4d00b0d69f_fuels-dens_2100_000.png
12,180,0.425,1,1,107966,7345,115311,images/run_b199da07-c45e-4c12-a213-de6faf9db329_fuels-dens_2100_000.png
12,180,0.425,1,1,91468,4265,95733,images/run_fe5cf711-96cc-4586-b94d-2beb819cf0cf_fuels-dens_2100_000.png
2,225,0.5,0,0,19325,0,19325,images/run_c993a4a1-69a6-4bc4-a80e-8c94d4e8d96c_fuels-dens_2100_000.png
8,180,0.5,0,0,78996,251,79247,images/run_9c37c008-202a-4f25-9e4f-284038da5fc7_fuels-dens_2100_000.png
8,180,0.5,0,0,31711,2207,33918,images/run_1fb0ea15-8bc6-4b4d-b162-a109d81baa15_fuels-dens_2100_000.png
2,225,0.5,0,0,97365,135,97500,images/run_965b43eb-d882-4afd-bb07-b6eead64bef2_fuels-dens_2100_000.png
2,270,0.5,0,0,66715,0,66715,images/run_8c560cd6-9cba-4e81-b8a9-f22429cd2c61_fuels-dens_2100_000.png
5,240,0.5,0,0,105336,773,106109,images/run_0b8e14e3-934f-4bc6-8dde-6032fd2f8334_fuels-dens_2100_000.png
5,240,0.5,0,0,22259,1837,24096,images/run_ae29a895-faf9-4676-bacf-110b33276fdc_fuels-dens_2100_000.png
5,270,0.5,0,0,63216,0,63216,images/run_dac2bfd9-0d7f-487a-9105-1ae8ace6fc91_fuels-dens_2100_000.png
8,195,0.5,0,0,25215,2084,27299,images/run_6bc55067-ce38-4c0a-a2b5-20eb0789d0c8_fuels-dens_2100_000.png
5,240,0.5,0,0,73158,0,73158,images/run_e9b12363-2177-48c3-8595-373afd1c2c31_fuels-dens_2100_000.png
2,195,0.5,0,0,95899,158,96057,images/run_37e0007b-ec54-474e-8197-6bdc06f8ef4a_fuels-dens_2100_000.png
8,195,0.5,1,1,100625,4626,105251,images/run_4497b15b-ec10-4325-8291-120bf7f11939_fuels-dens_2100_000.png
2,255,0.5,0,0,71024,0,71024,images/run_dc20202f-b9ac-4ad4-85de-a93af896e7bf_fuels-dens_2100_000.png
8,180,0.5,0,0,95738,2616,98354,images/run_e43a4ddb-0429-4012-97a9-4c02f1e67be5_fuels-dens_2100_000.png
8,195,0.5,0,0,84219,504,84723,images/run_17bdf5a9-46e3-4a7c-9646-6b0a0cf097d0_fuels-dens_2100_000.png
5,270,0.5,0,0,22439,0,22439,images/run_43639618-06cd-4ff1-bfbf-469ff1938e28_fuels-dens_2100_000.png
2,175,0.5,0,0,23636,179,23815,images/run_6d8952b0-21c3-4dda-adb7-4b2c5a278887_fuels-dens_2100_000.png
2,255,0.5,0,0,67576,0,67576,images/run_2794ebf4-ae10-4420-94ab-387a111ea4be_fuels-dens_2100_000.png
2,240,0.5,0,0,97133,74,97207,images/run_97f42d12-9b52-4af4-91d6-f6a1eb5f1ad4_fuels-dens_2100_000.png
2,240,0.5,0,0,98986,214,99200,images/run_01264eec-a1c2-4e9f-b151-514bcdddfd66_fuels-dens_2100_000.png
2,180,0.5,0,0,95951,234,96185,images/run_e9c3dfbb-cfad-4bca-86c4-0dff44208bbf_fuels-dens_2100_000.png
2,180,0.5,0,0,22812,150,22962,images/run_a64b905a-160d-4a74-b0bd-7b54e8a91d16_fuels-dens_2100_000.png
5,255,0.5,0,0,102118,0,102118,images/run_5b561bc2-9e4b-49dd-86f6-595b584f29a0_fuels-dens_2100_000.png
2,180,0.5,0,0,66953,0,66953,images/run_55303920-273a-489d-8273-058b14244168_fuels-dens_2100_000.png
2,225,0.5,0,0,69119,0,69119,images/run_481e7a00-1019-411c-837f-9ed531dcf62b_fuels-dens_2100_000.png
2,240,0.5,0,0,18086,10,18096,images/run_0a620b40-4556-4748-a0ad-a0fe625bb64b_fuels-dens_2100_000.png
2,240,0.5,0,0,70880,0,70880,images/run_72394bef-c2fc-4ebb-bfd4-599c78573a34_fuels-dens_2100_000.png
2,175,0.5,0,0,65747,0,65747,images/run_eb96d1f3-a4ea-4dc2-97e5-7352f9d543d0_fuels-dens_2100_000.png
2,255,0.5,0,0,16705,0,16705,images/run_c2aabe78-624b-4798-aa53-8ab5351ceb76_fuels-dens_2100_000.png
5,255,0.5,0,0,22971,219,23190,images/run_249af42c-dccb-4c55-ae02-42bc88ccb2f1_fuels-dens_2100_000.png
2,195,0.5,0,0,68894,0,68894,images/run_8ace4806-f438-4ffa-9b80-f93832ceb462_fuels-dens_2100_000.png
8,175,0.5,0,0,75148,383,75531,images/run_f85ed816-b291-4654-8597-d751a2b70798_fuels-dens_2100_000.png
5,255,0.5,0,0,67448,0,67448,images/run_56ba2889-6ec4-458e-b2c2-803168171f8b_fuels-dens_2100_000.png
8,175,0.5,0,0,29441,916,30357,images/run_0e7ca955-09c2-445b-99ee-b2e2a75c59e4_fuels-dens_2100_000.png
2,195,0.5,0,0,22492,88,22580,images/run_d5f88ddd-b740-4c58-9f5b-7f66c5c12f91_fuels-dens_2100_000.png
8,175,0.5,1,1,94693,2896,97589,images/run_3dc32686-24ff-4a0d-91a9-1c0a84406247_fuels-dens_2100_000.png
5,270,0.5,0,0,96572,0,96572,images/run_8ca2f472-4d11-480d-8d51-06073448f6e0_fuels-dens_2100_000.png
2,270,0.5,0,0,18121,0,18121,images/run_d4583ae7-5f71-4c4c-bef6-cc2d3ea19749_fuels-dens_2100_000.png
2,175,0.5,0,0,93957,99,94056,images/run_7d12516c-1726-4f46-b59d-525afbc5a677_fuels-dens_2100_000.png
2,255,0.5,0,0,98008,0,98008,images/run_2a6d96d7-1d8e-4ce9-889c-f590a1e1f2cd_fuels-dens_2100_000.png
8,225,0.5,1,1,106924,7642,114566,images/run_ab2c91f8-262f-428f-b08e-4f8812879ec7_fuels-dens_2100_000.png
8,270,0.5,0,0,69872,0,69872,images/run_fa198f66-4f06-456d-8446-6a7dda907186_fuels-dens_2100_000.png
8,225,0.5,0,0,89932,250,90182,images/run_bd9a0d0b-d3f6-47cd-9f86-6561691a39da_fuels-dens_2100_000.png
12,180,0.5,1,1,94442,5911,100353,images/run_af0af1ef-235c-4fef-8b93-53f243fa4971_fuels-dens_2100_000.png
2,180,0.5,0,0,68511,0,68511,images/run_438b9441-060d-47bf-add1-71ae4b46b8f8_fuels-dens_2100_000.png
2,180,0.5,0,0,22998,206,23204,images/run_0a9eb76f-03f7-4bda-9656-4ff319c2e543_fuels-dens_2100_000.png
2,180,0.5,0,0,95362,0,95362,images/run_dac9961f-f553-4661-9660-47d2b776f601_fuels-dens_2100_000.png
12,255,0.5,0,0,98807,827,99634,images/run_ef83977f-2bf9-474e-ab15-91180161965b_fuels-dens_2100_000.png
12,255,0.5,0,0,31280,1179,32459,images/run_2b167d8c-fb78-4fad-a67a-1488409c45cf_fuels-dens_2100_000.png
12,255,0.5,1,1,80279,738,81017,images/run_e4b874c9-57c1-4953-9f13-456d63348421_fuels-dens_2100_000.png
12,195,0.5,1,1,81126,2230,83356,images/run_fa8128f8-f575-405a-93a8-63226aa8ebc5_fuels-dens_2100_000.png
2,175,0.5,0,0,96463,77,96540,images/run_5b128abd-ac39-45c0-8179-a1aea82f600c_fuels-dens_2100_000.png
12,195,0.5,1,1,28314,9581,37895,images/run_a299f7d9-89ec-452c-88c2-7eca98402cf6_fuels-dens_2100_000.png
12,240,0.5,1,1,23480,3044,26524,images/run_2f5c3f8d-8009-468f-b8ef-4fd34a76381e_fuels-dens_2100_000.png
12,240,0.5,0,0,87630,1116,88746,images/run_5d8085b1-acc4-4d97-bf97-499b97f633bb_fuels-dens_2100_000.png
12,195,0.5,1,1,98737,7951,106688,images/run_0027e586-0f94-4860-bf80-ca6b35c70155_fuels-dens_2100_000.png
12,225,0.5,1,1,100876,13184,114060,images/run_cbfa3937-ecc8-48bf-99da-65929ed6cef8_fuels-dens_2100_000.png
12,225,0.5,1,1,25074,10319,35393,images/run_090e4384-069a-4c87-bf53-852bcfabb0eb_fuels-dens_2100_000.png
12,225,0.5,1,1,90872,6670,97542,images/run_ee00577f-061f-4d6f-b13a-917ebcac1994_fuels-dens_2100_000.png
12,225,0.5,1,1,86402,3125,89527,images/run_dc043e20-8d81-4ac1-a58d-e72340a3d73c_fuels-dens_2100_000.png
12,225,0.5,1,1,24660,19838,44498,images/run_23b55c9d-809a-4c7d-b0c1-0a390b1c0bf1_fuels-dens_2100_000.png
12,240,0.5,1,1,103624,9356,112980,images/run_dcb9cf40-e91f-4c16-ada6-533a933dae60_fuels-dens_2100_000.png
12,195,0.5,1,1,94379,6485,100864,images/run_e52c7f7d-d3c1-4269-8c60-e57156118604_fuels-dens_2100_000.png
2,175,0.5,0,0,23565,203,23768,images/run_6ef2db81-0ed1-4419-8b28-b5a8f9b03fc8_fuels-dens_2100_000.png
12,180,0.5,0,1,75219,2472,77691,images/run_822082bb-be91-4237-8c02-1e8c2b003e10_fuels-dens_2100_000.png
3,255,0.5,0,0,18837,0,18837,images/run_406214a6-9e42-41f2-9678-ceaecfc47255_fuels-dens_2100_000.png
8,255,0.5,0,0,27247,298,27545,images/run_44603df8-3fc0-44b1-b9bd-ff70f1be8fe3_fuels-dens_2100_000.png
12,240,0.5,1,1,104736,9133,113869,images/run_b8f127b5-3fa1-4e68-9576-ada38942c789_fuels-dens_2100_000.png
8,270,0.5,0,0,70957,0,70957,images/run_b8e07dcf-8306-476a-b110-90e79302d904_fuels-dens_2100_000.png
8,270,0.5,0,0,32759,0,32759,images/run_a4da2805-41ae-4323-87b5-08eea7d94dd2_fuels-dens_2100_000.png
8,270,0.5,0,0,101183,0,101183,images/run_17536ab4-5dc5-49d3-9e4e-95e0a9259b43_fuels-dens_2100_000.png
8,255,0.5,0,0,76719,0,76719,images/run_e7a36fa6-e86d-48eb-b87a-932749c41981_fuels-dens_2100_000.png
8,240,0.5,0,1,109644,2771,112415,images/run_5d297bb1-5144-4caf-a4b8-f447fac147e3_fuels-dens_2100_000.png
2,175,0.5,0,0,67014,0,67014,images/run_96333209-18a3-4143-91f1-8958ee22da3e_fuels-dens_2100_000.png
8,240,0.5,0,0,26275,890,27165,images/run_8016b5b6-7870-4b79-ba6a-f267745ad540_fuels-dens_2100_000.png
12,180,0.5,1,1,30550,2376,32926,images/run_a64e5d6c-696f-4793-9703-b2aa46d547ad_fuels-dens_2100_000.png
8,225,0.5,0,0,88998,549,89547,images/run_0eaa73e8-b2b1-4836-be05-0e1aca73b055_fuels-dens_2100_000.png
12,270,0.5,0,0,97284,587,97871,images/run_2ecf2701-ce54-4588-9346-09f4a1d6d5a0_fuels-dens_2100_000.png
12,270,0.5,0,0,33969,0,33969,images/run_613b81ac-fa2b-4bb2-88d4-28f0c86881c7_fuels-dens_2100_000.png
12,270,0.5,0,0,76174,0,76174,images/run_def049ca-4882-4991-b7cf-144f988b4f1d_fuels-dens_2100_000.png
12,175,0.5,1,1,71096,2290,73386,images/run_38fbd8da-e67e-4f97-8166-b9115995f13e_fuels-dens_2100_000.png
12,175,0.5,1,1,38476,3550,42026,images/run_55c50808-d0ce-41d2-ab02-44aa92998fa2_fuels-dens_2100_000.png
12,175,0.5,1,1,90454,4824,95278,images/run_9d72d862-6be1-44bd-b0cf-40544617f069_fuels-dens_2100_000.png
8,240,0.5,0,0,83722,0,83722,images/run_ea162642-6432-469b-9c95-bfd581807fe0_fuels-dens_2100_000.png
12,195,0.5,1,1,25282,13810,39092,images/run_cff12211-9b40-49aa-b220-7d44d0e5dd1f_fuels-dens_2100_000.png
12,195,0.5,1,1,83197,2396,85593,images/run_6b5d58e9-b9e1-4387-a09a-b8255db5eff3_fuels-dens_2100_000.png
12,225,0.5,1,1,105750,19396,125146,images/run_a7c143b2-914a-43e3-96d2-d30a246c05f9_fuels-dens_2100_000.png
2,225,0.5,0,0,20824,293,21117,images/run_4c707026-6a86-4dbd-b0e7-fd9483217a06_fuels-dens_2100_000.png
2,225,0.5,0,0,98360,16,98376,images/run_de416f12-92e4-48e2-94eb-5697ff40f554_fuels-dens_2100_000.png
12,270,0.5,0,0,74429,0,74429,images/run_05261b2d-53d6-4f07-8e55-a654d39402d9_fuels-dens_2100_000.png
12,270,0.5,0,0,39117,505,39622,images/run_f13c44f5-cae1-4299-afc5-ae23ed04d832_fuels-dens_2100_000.png
12,270,0.5,0,0,102307,0,102307,images/run_a1725c4f-27cd-443f-9a55-748bba779ac6_fuels-dens_2100_000.png
2,240,0.5,0,0,69828,0,69828,images/run_d129699b-d0c3-477d-b8fe-f6ec2d5017f9_fuels-dens_2100_000.png
2,240,0.5,0,0,18917,0,18917,images/run_d4e00d48-f422-467e-95fb-509fe0c54f93_fuels-dens_2100_000.png
8,255,0.5,0,0,101560,868,102428,images/run_59b9f6a5-aa79-452d-ae59-ff7638aa3aa2_fuels-dens_2100_000.png
2,225,0.5,0,0,67319,0,67319,images/run_fae9f1aa-7aab-4acf-9e15-9f16c12944eb_fuels-dens_2100_000.png
8,255,0.5,0,0,26414,292,26706,images/run_1716b434-66de-4c4b-957b-d57c02c023f4_fuels-dens_2100_000.png
8,195,0.5,0,0,83734,0,83734,images/run_de3dd42b-16ca-4203-b254-68b818dac0f7_fuels-dens_2100_000.png
8,240,0.5,0,0,107429,1738,109167,images/run_fe224b5f-47f7-4b2b-9170-ed15cf377428_fuels-dens_2100_000.png
8,240,0.5,1,1,22727,2442,25169,images/run_a2838a97-7fb4-4f5b-a3ef-6560d4aea827_fuels-dens_2100_000.png
8,240,0.5,0,0,85154,253,85407,images/run_d6d5b09c-15be-469f-8bde-3f9a3181f7d9_fuels-dens_2100_000.png
8,180,0.5,1,1,99085,3189,102274,images/run_bea23cee-d629-4172-9432-5c77e3076f90_fuels-dens_2100_000.png
8,180,0.5,1,1,31885,4340,36225,images/run_3b825468-ef4e-4d87-9c82-46ad77fc2564_fuels-dens_2100_000.png
8,225,0.5,1,1,104978,5426,110404,images/run_91494686-fa40-4c47-8123-d4dd6a6a61ac_fuels-dens_2100_000.png
8,225,0.5,1,1,23125,4753,27878,images/run_81b95b37-4076-427d-b697-c5a586fe8b24_fuels-dens_2100_000.png
8,255,0.5,0,0,76557,4,76561,images/run_c03b005f-8a5e-4749-9849-e7f1540dd39f_fuels-dens_2100_000.png
8,195,0.5,1,1,29092,4276,33368,images/run_600bb85c-99ae-4099-ae3d-61437fb8ac3a_fuels-dens_2100_000.png
8,195,0.5,1,1,100990,3562,104552,images/run_5d9ab4c9-a38d-484f-9727-c661c5691400_fuels-dens_2100_000.png
2,255,0.5,0,0,17228,0,17228,images/run_8d1406aa-9038-4f87-b297-6d551c7ea091_fuels-dens_2100_000.png
12,180,0.5,1,1,91626,4283,95909,images/run_c34810a0-fd6e-47bb-9a4f-2e1912b6de5e_fuels-dens_2100_000.png
12,180,0.5,1,1,26457,4644,31101,images/run_8c6e28a6-eca4-4bb2-a50c-2967a772f459_fuels-dens_2100_000.png
12,180,0.5,0,0,74573,1435,76008,images/run_43cad91f-e0aa-484c-a820-57836b54d2af_fuels-dens_2100_000.png
12,240,0.5,0,0,89767,341,90108,images/run_25eeb2af-3399-489f-9b97-f993f4c6987f_fuels-dens_2100_000.png
12,240,0.5,1,1,30699,5870,36569,images/run_a9e01c2e-99c8-44c2-a392-abe2d5439197_fuels-dens_2100_000.png
12,175,0.5,1,1,88999,4529,93528,images/run_fb2d7ec5-6920-4930-93a5-07112af1616d_fuels-dens_2100_000.png
12,175,0.5,1,1,32516,3621,36137,images/run_438931a0-f9e5-4749-a4f2-083083e6a0b9_fuels-dens_2100_000.png
12,175,0.5,0,1,74292,1754,76046,images/run_40d9c8fe-b046-437d-8243-afd5314d9c72_fuels-dens_2100_000.png
12,240,0.5,1,1,107453,8571,116024,images/run_a5ba7ecf-6350-486d-a168-ee9ac981a354_fuels-dens_2100_000.png
12,255,0.5,0,0,82419,223,82642,images/run_5b1ec8e8-233e-430b-9ffa-f2dbc794cf9b_fuels-dens_2100_000.png
12,255,0.5,1,1,35207,5036,40243,images/run_d67c55ea-1dc8-491a-9576-f2374d872e42_fuels-dens_2100_000.png
12,255,0.5,1,1,103259,2643,105902,images/run_ac7e9656-566e-4bde-a0c8-62ddf1f7ede1_fuels-dens_2100_000.png
8,225,0.5,1,1,109422,5800,115222,images/run_d23d749b-3c94-49d1-b75e-11a3a4229101_fuels-dens_2100_000.png
2,195,0.5,0,0,68269,0,68269,images/run_15db03d1-b4bb-4fb5-be54-02f4f4382e76_fuels-dens_2100_000.png
2,195,0.5,0,0,21717,87,21804,images/run_8abebaa2-4d37-4093-9ef0-cdc4e1956dd4_fuels-dens_2100_000.png
2,195,0.5,0,0,95938,414,96352,images/run_de5743a3-b346-4a13-90a8-2839ecf2fdb3_fuels-dens_2100_000.png
8,225,0.5,1,1,25388,7675,33063,images/run_47665f4f-11c3-42c5-bc36-56fac33303f1_fuels-dens_2100_000.png
8,270,0.5,0,0,96961,50,97011,images/run_1acf74c8-1047-4b1a-91b5-163011b200b0_fuels-dens_2100_000.png
8,270,0.5,0,0,27781,0,27781,images/run_fa9a8975-5d8c-4859-80eb-12e512b05cf9_fuels-dens_2100_000.png
8,180,0.5,0,0,79172,68,79240,images/run_482c457d-5fbc-478d-8970-0d9919b1b59b_fuels-dens_2100_000.png
2,255,0.5,0,0,95657,0,95657,images/run_1bfb2881-48b8-493b-b365-784e8ca7a9ca_fuels-dens_2100_000.png
3,270,0.5,0,0,96259,0,96259,images/run_51988f95-b39b-4718-963f-191b00239f4d_fuels-dens_2100_000.png
5,225,0.5,0,0,22434,859,23293,images/run_3419307b-c97e-454c-9218-8aed2d38c80e_fuels-dens_2100_000.png
3,255,0.5,0,0,100726,83,100809,images/run_d07d4ab6-dbff-40fb-b554-a8a673a8e85b_fuels-dens_2100_000.png
5,225,0.5,0,0,105425,1154,106579,images/run_05875ec2-07f2-46b9-be5c-750e68a68811_fuels-dens_2100_000.png
12,270,0.5,0,0,98021,570,98591,images/run_104a6ae2-f171-4a06-9ce9-e78512b5ddf9_fuels-dens_2100_000.png
12,270,0.5,0,0,32284,565,32849,images/run_c5ba8518-80d3-4027-a57c-66dcba67754a_fuels-dens_2100_000.png
12,270,0.5,0,0,79827,0,79827,images/run_3d4159cd-4978-4a62-a9a1-ff45ed78022b_fuels-dens_2100_000.png
5,240,0.5,0,0,73848,0,73848,images/run_30bf0c86-6274-49fb-bc46-ec5cbdae7da1_fuels-dens_2100_000.png
5,240,0.5,0,0,22102,569,22671,images/run_b2495079-7fef-4144-8f8f-f818555a9788_fuels-dens_2100_000.png
5,240,0.5,0,0,106779,913,107692,images/run_a5ea3134-1162-4381-a7fd-3ae40b535286_fuels-dens_2100_000.png
5,255,0.5,0,0,67076,0,67076,images/run_7fa0264d-a245-436b-9415-eb0b3755f013_fuels-dens_2100_000.png
5,255,0.5,0,0,22885,0,22885,images/run_289b476a-dc2b-49ef-8748-8ef5f9ff0270_fuels-dens_2100_000.png
3,270,0.5,0,0,60238,0,60238,images/run_c6538f9c-a938-4aa6-aac8-cd54e43354cb_fuels-dens_2100_000.png
3,270,0.5,0,0,18379,68,18447,images/run_41d2ae7f-b9c8-4228-a95e-a42629c1899c_fuels-dens_2100_000.png
12,255,0.5,1,1,103275,2599,105874,images/run_c73f693a-395e-4c77-aa85-b3c4bbe61fe4_fuels-dens_2100_000.png
12,255,0.5,0,0,33254,1222,34476,images/run_2267b2c7-862e-4bbd-883c-12b8c760394c_fuels-dens_2100_000.png
12,255,0.5,0,0,83771,29,83800,images/run_23459fc8-de7f-426e-97f3-af528130a030_fuels-dens_2100_000.png
5,225,0.5,0,0,107973,729,108702,images/run_f311b344-268f-4589-bb88-896ad7a37cc1_fuels-dens_2100_000.png
5,225,0.5,0,0,22460,1104,23564,images/run_55f2ee50-dcf3-4b8a-b624-aa1ad9ebf653_fuels-dens_2100_000.png
12,240,0.5,1,1,23562,7673,31235,images/run_a5ba8a3f-bf77-49f6-9930-456283334876_fuels-dens_2100_000.png
3,255,0.5,0,0,19787,0,19787,images/run_ba407abc-cb15-40aa-8a00-92b34d9f4b35_fuels-dens_2100_000.png
12,240,0.5,1,1,90711,1390,92101,images/run_431e2742-65a0-4d4e-9968-38b1278220bb_fuels-dens_2100_000.png
3,255,0.5,0,0,63981,0,63981,images/run_3a96ac5f-4f1e-40f6-8b15-17591f7724eb_fuels-dens_2100_000.png
5,225,0.5,0,0,78575,114,78689,images/run_4abb1980-1639-41d2-8e67-e592f5f53528_fuels-dens_2100_000.png
2,225,0.5,0,0,98503,160,98663,images/run_5280fe79-4fb0-496e-9a46-64ecc3fb59d8_fuels-dens_2100_000.png
2,225,0.5,0,0,19613,158,19771,images/run_da15eb0e-e994-4b2c-b195-e2ddb0365fb1_fuels-dens_2100_000.png
2,225,0.5,0,0,69850,0,69850,images/run_fba1767c-dd73-42b6-ad94-1a26ac0f8c1f_fuels-dens_2100_000.png
2,195,0.5,0,0,95674,68,95742,images/run_a4bd2f87-cee5-4fbe-8dcd-9a917d1df347_fuels-dens_2100_000.png
2,195,0.5,0,0,21566,0,21566,images/run_59a96ed1-4077-4fd3-9e7a-f9c9766dcf35_fuels-dens_2100_000.png
2,195,0.5,0,0,66786,0,66786,images/run_903dd35f-1b57-4357-b3f8-3aea10ec4d03_fuels-dens_2100_000.png
5,180,0.5,0,0,74027,0,74027,images/run_a68aee0c-82b5-40e1-92f5-3aea054276d3_fuels-dens_2100_000.png
5,180,0.5,0,0,30624,0,30624,images/run_e7b02bb9-4593-4e35-8bbe-3f64922689a1_fuels-dens_2100_000.png
2,180,0.5,0,0,94880,77,94957,images/run_ad381011-1602-4dd8-bbf5-21239524fc42_fuels-dens_2100_000.png
2,180,0.5,0,0,23383,108,23491,images/run_06b7fa6b-2ec2-4e6b-b059-092112eb58d6_fuels-dens_2100_000.png
2,180,0.5,0,0,66869,0,66869,images/run_e256c3ea-a4f1-4a0b-8a9c-1a67fe03bd31_fuels-dens_2100_000.png
5,180,0.5,0,0,97845,617,98462,images/run_b9592ce4-4813-4364-967e-4f977801297c_fuels-dens_2100_000.png
2,175,0.5,0,0,94567,156,94723,images/run_e7fd2e2e-c078-47a2-849c-d7f86a92c4ed_fuels-dens_2100_000.png
2,175,0.5,0,0,22511,162,22673,images/run_80e4f961-1b5d-4cf2-9135-b835a55f2614_fuels-dens_2100_000.png
2,175,0.5,0,0,66307,0,66307,images/run_582341a2-f075-4255-bcc6-0116bf74ba91_fuels-dens_2100_000.png
5,195,0.5,0,0,78877,0,78877,images/run_54b30d86-e0e9-4c20-98ec-0fe92af87348_fuels-dens_2100_000.png
5,195,0.5,0,0,27813,1631,29444,images/run_257ffc78-b2e2-450a-8e97-56742b149193_fuels-dens_2100_000.png
5,195,0.5,0,0,101553,976,102529,images/run_82674e30-dcf9-4832-9849-85d86679553a_fuels-dens_2100_000.png
3,240,0.5,0,0,102723,239,102962,images/run_0f0aa91a-4164-4cc0-b713-671776c36b76_fuels-dens_2100_000.png
5,225,0.5,0,0,21911,1796,23707,images/run_4d6b91ef-de53-44ee-9065-fb25463393f0_fuels-dens_2100_000.png
5,175,0.5,0,0,97228,503,97731,images/run_dfe125a3-b8d3-4ff8-8fe1-a75692753934_fuels-dens_2100_000.png
5,225,0.5,0,0,82390,0,82390,images/run_768e227f-945e-4427-b1d8-83fe25dfa8ff_fuels-dens_2100_000.png
12,225,0.5,1,1,28488,20275,48763,images/run_8568af0f-d2b7-4064-a38d-2ecc4fab0cb3_fuels-dens_2100_000.png
8,270,0.5,0,0,73576,0,73576,images/run_ac2bd4e6-0cd4-405e-a17e-3a56e1c7b3a7_fuels-dens_2100_000.png
8,175,0.5,1,1,31735,2681,34416,images/run_49409441-1b19-436e-a501-c41577761ec3_fuels-dens_2100_000.png
8,175,0.5,1,1,95444,2619,98063,images/run_176c8c3d-0666-4178-8a9f-ceacc28826d0_fuels-dens_2100_000.png
8,180,0.5,0,0,80582,613,81195,images/run_a7331b6f-8e85-477a-9622-2eea48908255_fuels-dens_2100_000.png
8,180,0.5,1,1,31883,2952,34835,images/run_c0017d09-9e04-4a80-8f39-fb22fd863ca5_fuels-dens_2100_000.png
8,180,0.5,1,1,97019,4374,101393,images/run_8cf6e53f-353e-4b84-9755-37530ffda049_fuels-dens_2100_000.png
5,175,0.5,0,0,75657,0,75657,images/run_3a26fb50-916a-4bbb-a951-e6fc51636626_fuels-dens_2100_000.png
5,175,0.5,1,1,32947,2336,35283,images/run_53b2399c-65ea-4813-b1ff-b5166b9db479_fuels-dens_2100_000.png
5,175,0.5,0,0,98364,1040,99404,images/run_67ae49b2-c9ed-4363-bf3f-104ab9e47e34_fuels-dens_2100_000.png
8,195,0.5,0,0,83969,138,84107,images/run_fad86f4a-c8f3-4146-b616-8c9f22e18d4d_fuels-dens_2100_000.png
8,255,0.5,0,0,103862,0,103862,images/run_15f05a1e-ec53-451a-9a9b-836b05f88bc2_fuels-dens_2100_000.png
8,255,0.5,0,0,27333,0,27333,images/run_e6702b60-2c0f-46da-a736-c311817174b3_fuels-dens_2100_000.png
8,255,0.5,0,0,79016,0,79016,images/run_161dc427-d769-46ac-893c-939ec4699721_fuels-dens_2100_000.png
8,195,0.5,1,1,30051,4836,34887,images/run_88b813b3-07ce-4742-b87e-0b76443da7f6_fuels-dens_2100_000.png
8,195,0.5,1,1,101847,7236,109083,images/run_5ecd022e-3d41-4c5f-a15b-ebbd7c31c1c9_fuels-dens_2100_000.png
8,240,0.5,0,0,106717,2617,109334,images/run_6802fa99-1d7c-4107-8d3e-e00bba590680_fuels-dens_2100_000.png
8,240,0.5,1,1,25162,5114,30276,images/run_fd8041c7-88a6-4a59-b10d-7bf95e733c03_fuels-dens_2100_000.png
8,240,0.5,0,0,85241,561,85802,images/run_7ed6e6e0-0d8b-4cbd-9eb2-b8a08b5b1c9c_fuels-dens_2100_000.png
8,270,0.5,0,0,29565,375,29940,images/run_a2e2c47b-2621-4c5b-9856-5424cbc68259_fuels-dens_2100_000.png
12,225,0.5,1,1,102269,21846,124115,images/run_c74dda82-9454-4ff2-99ab-551b76b53d0b_fuels-dens_2100_000.png
8,270,0.5,0,0,98778,0,98778,images/run_6d5d385a-e075-49df-8c6e-6f806718bcbc_fuels-dens_2100_000.png
5,180,0.5,0,0,76411,0,76411,images/run_4ac1791f-aefd-43a3-ad1b-03062eb62402_fuels-dens_2100_000.png
12,225,0.5,1,1,92563,5257,97820,images/run_8a72a8c1-c62a-4270-93fb-d2314cebbd45_fuels-dens_2100_000.png
12,195,0.5,1,1,99014,9555,108569,images/run_9439637f-454f-495f-9c4e-ff2636b707e1_fuels-dens_2100_000.png
12,195,0.5,1,1,26499,8638,35137,images/run_2211e337-0b6f-4811-ae3d-a14ab3051d56_fuels-dens_2100_000.png
12,195,0.5,1,1,86287,3357,89644,images/run_a9fee1bc-885c-48f4-9fa0-94c245f6a60f_fuels-dens_2100_000.png
5,270,0.5,0,0,65783,0,65783,images/run_96ae3a88-c8f7-4ec6-a002-f770f8613924_fuels-dens_2100_000.png
12,180,0.5,1,1,91952,6513,98465,images/run_8041e1da-c4ff-4016-ab5f-3625fdc887e9_fuels-dens_2100_000.png
12,180,0.5,1,1,28998,6380,35378,images/run_7e4f460b-19e8-4b6e-a8c9-8c896135ca68_fuels-dens_2100_000.png
12,180,0.5,1,1,80090,2296,82386,images/run_c2632199-e3df-42f7-9946-f711d06a4245_fuels-dens_2100_000.png
5,270,0.5,0,0,25024,337,25361,images/run_77097ae2-b7bd-486f-8e28-086ca2b805d0_fuels-dens_2100_000.png
5,270,0.5,0,0,97336,0,97336,images/run_35a123a6-9df8-47a0-8a47-17a4f67a9b88_fuels-dens_2100_000.png
5,195,0.5,0,0,102888,1400,104288,images/run_e2a101c8-de4e-4b34-aa3f-aa07a6d6ad82_fuels-dens_2100_000.png
12,175,0.5,1,1,90583,4079,94662,images/run_d02f679d-9f34-4486-bd2a-16c99197679a_fuels-dens_2100_000.png
12,175,0.5,1,1,32609,2180,34789,images/run_69aedb0e-61f5-46bd-8a49-e059a8cfc9c0_fuels-dens_2100_000.png
12,175,0.5,1,1,75262,2232,77494,images/run_87f9bb68-10ee-4288-bc14-6e53d7177e06_fuels-dens_2100_000.png
5,195,0.5,1,0,26415,747,27162,images/run_1036ec63-8186-4c9b-8717-f4d5f8b4c24e_fuels-dens_2100_000.png
5,195,0.5,0,0,80350,0,80350,images/run_460fc175-8bf6-431f-829a-7bc0f87608e6_fuels-dens_2100_000.png
5,180,0.5,0,0,99423,1079,100502,images/run_4d9fb678-99db-4d68-9ea5-577a232ee951_fuels-dens_2100_000.png
3,270,0.5,0,0,99265,82,99347,images/run_1601503d-b59f-4f4f-8397-0fc52350a8b3_fuels-dens_2100_000.png
5,180,0.5,0,0,30751,447,31198,images/run_30776300-8c18-4761-af1a-65376064de8d_fuels-dens_2100_000.png
8,175,0.5,0,0,77470,428,77898,images/run_5f3ed1a4-dee1-48e0-8597-ffd4f731a0e4_fuels-dens_2100_000.png
5,175,0.5,0,0,28643,944,29587,images/run_9f93b212-1bd9-455d-ba05-71520fc777fc_fuels-dens_2100_000.png
5,175,0.5,0,0,73718,0,73718,images/run_4e2ce4bd-296c-4166-9dcf-aa2efc67e9ac_fuels-dens_2100_000.png
2,240,0.5,0,0,70439,0,70439,images/run_d8cd0e01-8269-4fa4-8d5f-2fac4e0c942d_fuels-dens_2100_000.png
3,270,0.5,0,0,18243,0,18243,images/run_173b11da-654d-4da6-8ba1-6493e2cb9d8b_fuels-dens_2100_000.png
3,270,0.5,0,0,61121,0,61121,images/run_87738ba4-5477-45d4-8bbb-7d21a63b52b9_fuels-dens_2100_000.png
3,175,0.5,0,0,94814,543,95357,images/run_6d3c114c-fd0a-4fdf-829a-f55633cd44e6_fuels-dens_2100_000.png
3,180,0.5,0,0,69255,0,69255,images/run_4cc48a0b-68ef-4fa5-a879-73b002421f0e_fuels-dens_2100_000.png
3,180,0.5,0,0,25745,161,25906,images/run_d6540e86-7905-4f4d-8e8d-02a75cf9763c_fuels-dens_2100_000.png
3,180,0.5,0,0,95872,136,96008,images/run_008452dd-b2df-4ad9-8509-da9a99167bb1_fuels-dens_2100_000.png
3,175,0.5,0,0,68244,0,68244,images/run_e5a1f208-d62c-427c-84ce-06aabd843f47_fuels-dens_2100_000.png
3,175,0.5,0,0,26048,324,26372,images/run_4cf28212-8e53-4b60-aced-e8fa66a5dccb_fuels-dens_2100_000.png
3,175,0.5,0,0,97535,414,97949,images/run_57ab2534-cd3e-49b6-8f85-c4cb49a3317f_fuels-dens_2100_000.png
3,195,0.5,0,0,71540,0,71540,images/run_c0eea52c-0b04-43ea-87bf-58e497551206_fuels-dens_2100_000.png
3,180,0.5,0,0,70148,0,70148,images/run_8ba33bce-944e-417f-bf1f-b942068f2852_fuels-dens_2100_000.png
3,180,0.5,0,0,25200,218,25418,images/run_b34da31e-a3c2-4bde-883b-3089b0f6913f_fuels-dens_2100_000.png
3,255,0.5,0,0,99445,0,99445,images/run_af1045eb-e9a3-41a8-a7e1-12e7cb25647d_fuels-dens_2100_000.png
3,255,0.5,0,0,65578,0,65578,images/run_f1de5629-2bd4-4d39-b086-c261d2ce173b_fuels-dens_2100_000.png
3,195,0.5,0,0,24071,310,24381,images/run_28a29347-e723-41e5-aae9-88b21f9ec437_fuels-dens_2100_000.png
3,195,0.5,0,0,97952,554,98506,images/run_b754416d-d368-4bbd-8dee-233cb2cba24a_fuels-dens_2100_000.png
3,240,0.5,0,0,99605,0,99605,images/run_b3de3e82-b196-4919-8850-5601f60ceede_fuels-dens_2100_000.png
3,240,0.5,0,0,18999,389,19388,images/run_bb203eb2-e939-400a-883b-bc834c0b74a4_fuels-dens_2100_000.png
3,240,0.5,0,0,68814,0,68814,images/run_3bf63b48-181d-42e2-bbda-1dd0ed7d318b_fuels-dens_2100_000.png
8,225,0.5,1,1,25011,13476,38487,images/run_25989918-e848-4a1e-9897-fc7329bf6c73_fuels-dens_2100_000.png
3,225,0.5,0,0,71075,0,71075,images/run_854a2a90-0f07-4095-ae8e-e6f3b9ccae9a_fuels-dens_2100_000.png
3,175,0.5,0,0,24925,258,25183,images/run_99aac3aa-7eda-4cb8-a50b-8c16788743be_fuels-dens_2100_000.png
5,270,0.5,0,0,62693,0,62693,images/run_4e7574ec-a10d-483e-842f-187b34cc56bb_fuels-dens_2100_000.png
5,225,0.5,0,0,79799,94,79893,images/run_372fe309-4f2e-4c8a-83be-67f68a500e91_fuels-dens_2100_000.png
8,175,0.5,1,1,97531,5413,102944,images/run_79645248-214d-4183-8f62-a93d8d76dab4_fuels-dens_2100_000.png
8,175,0.5,1,1,36324,2002,38326,images/run_508f0fb0-3843-4810-8858-161661c40bf7_fuels-dens_2100_000.png
5,195,0.5,0,0,100748,1038,101786,images/run_c3396b7f-9ccb-459f-831a-a3e6cb9d6509_fuels-dens_2100_000.png
5,195,0.5,1,1,25446,2489,27935,images/run_d7077341-d7fe-419d-b9de-753ded932ddc_fuels-dens_2100_000.png
5,195,0.5,0,0,78992,9,79001,images/run_138d2150-69fb-41ef-b7b3-a626b7d5796f_fuels-dens_2100_000.png
8,175,0.5,0,0,75843,564,76407,images/run_dc75e04d-81c1-4668-bc4b-d16aa3ee9b74_fuels-dens_2100_000.png
5,180,0.5,0,0,97305,771,98076,images/run_39438e53-3a59-4801-983e-2720d5357007_fuels-dens_2100_000.png
5,180,0.5,1,1,28249,1200,29449,images/run_585b5e41-34aa-4690-a03f-1ee45b534dcc_fuels-dens_2100_000.png
5,180,0.5,0,0,76150,0,76150,images/run_6cc4adc2-1c70-4c84-8cf6-b188037b3473_fuels-dens_2100_000.png
5,175,0.5,0,0,95564,274,95838,images/run_598279ec-6228-4703-8175-19b0f772968f_fuels-dens_2100_000.png
5,175,0.5,0,0,27593,404,27997,images/run_2db33742-1042-4059-aa21-8a2f880fd6b1_fuels-dens_2100_000.png
5,175,0.5,0,0,73731,0,73731,images/run_be8f4a1a-47dd-4c62-8d8a-5a4adece91c6_fuels-dens_2100_000.png
2,270,0.5,0,0,69742,0,69742,images/run_a6f9e55f-6864-40d7-beee-a65fec3ed2fe_fuels-dens_2100_000.png
2,270,0.5,0,0,18412,0,18412,images/run_78286fea-993e-47db-9f8d-6e3bb991f4ac_fuels-dens_2100_000.png
2,270,0.5,0,0,94267,0,94267,images/run_a4cd65b2-789c-4a0f-a881-e851281dc28a_fuels-dens_2100_000.png
5,270,0.5,0,0,100776,0,100776,images/run_52e23ae8-8417-4d16-b247-13141e335aa2_fuels-dens_2100_000.png
5,270,0.5,0,0,23371,0,23371,images/run_f5910fa3-024e-4e8c-a107-895ad06276cb_fuels-dens_2100_000.png
2,270,0.5,0,0,97155,0,97155,images/run_f98f9380-93ae-4ea5-af11-7f8d1098364c_fuels-dens_2100_000.png
3,175,0.5,0,0,66876,0,66876,images/run_bd8a2fe9-eaa4-4bd6-b871-8ff9203f0bbe_fuels-dens_2100_000.png
3,225,0.5,0,0,100377,248,100625,images/run_df2b5ac8-97f8-4cc1-8e4e-760a1ecc0ffd_fuels-dens_2100_000.png
3,225,0.5,0,0,21100,274,21374,images/run_38a5a66e-3c81-40a7-83a8-760e67eb2c28_fuels-dens_2100_000.png
3,225,0.5,0,0,69190,0,69190,images/run_abb9d814-d025-4daf-9e19-3f8d9d8d46e7_fuels-dens_2100_000.png
2,270,0.5,0,0,17319,0,17319,images/run_8e244a64-eb07-497d-94c8-626023de6a64_fuels-dens_2100_000.png
2,270,0.5,0,0,64776,0,64776,images/run_68547d92-9fe5-4ea9-8a95-fa0b4bea974e_fuels-dens_2100_000.png
3,270,0.5,0,0,96786,0,96786,images/run_69ddff37-b58f-4030-b568-dd7408633077_fuels-dens_2100_000.png
5,255,0.5,0,0,107170,0,107170,images/run_27a727b1-9df3-43ef-94f9-a8fa0f0a5127_fuels-dens_2100_000.png
5,255,0.5,0,0,24253,653,24906,images/run_a006efb3-3d7d-4c50-bd18-d36230d75f08_fuels-dens_2100_000.png
5,255,0.5,0,0,66786,0,66786,images/run_eae71206-6530-47a1-ad64-9c6a7034507f_fuels-dens_2100_000.png
5,240,0.5,0,0,108868,725,109593,images/run_2c29d9a9-0514-4016-ae70-7eb0cb6cf2ce_fuels-dens_2100_000.png
3,225,0.5,0,0,70498,0,70498,images/run_931b6ab4-9511-4583-a212-7198461346b2_fuels-dens_2100_000.png
3,225,0.5,0,0,20858,594,21452,images/run_de132987-1257-4c72-ab50-a3b0423f80b7_fuels-dens_2100_000.png
3,225,0.5,0,0,102583,335,102918,images/run_c7ac7c80-f0d7-43a5-850a-3fb164f64e71_fuels-dens_2100_000.png
5,240,0.5,1,1,24598,1758,26356,images/run_cb3db504-96b5-4bb1-8abe-5a399add8f2d_fuels-dens_2100_000.png
5,240,0.5,0,0,73941,0,73941,images/run_56f50fd8-023b-433f-a45e-4cbc0d9945ad_fuels-dens_2100_000.png
3,240,0.5,0,0,66992,0,66992,images/run_c2551b72-abd1-4e64-9264-ef58edf8d2e8_fuels-dens_2100_000.png
3,240,0.5,0,0,20369,301,20670,images/run_eed9a80a-98ad-4071-bddc-ed48fb434791_fuels-dens_2100_000.png
2,255,0.5,0,0,95884,0,95884,images/run_76ed62e7-8960-4f84-8b03-a4c4d08cd82d_fuels-dens_2100_000.png
2,255,0.5,0,0,16065,0,16065,images/run_c9c68de8-3266-42e6-a07b-87903171c865_fuels-dens_2100_000.png
2,255,0.5,0,0,68240,0,68240,images/run_1c64bd8b-9b0d-4aae-b348-77078e710e86_fuels-dens_2100_000.png
2,240,0.5,0,0,96450,165,96615,images/run_901849af-2b20-4b0d-9049-50b7ca372452_fuels-dens_2100_000.png
2,240,0.5,0,0,18444,309,18753,images/run_3f3e84b3-4a23-42f5-9c7c-60c589355620_fuels-dens_2100_000.png
2,270,0.5,0,0,95248,0,95248,images/run_93b3f2aa-eaeb-40fd-93c8-d8af492d2183_fuels-dens_2100_000.png
3,270,0.5,0,0,19350,0,19350,images/run_5310b417-a20f-480c-a3de-f21d3df473bb_fuels-dens_2100_000.png
3,270,0.5,0,0,61180,0,61180,images/run_250421a7-5aa8-45ae-baad-cc56b4ba5b21_fuels-dens_2100_000.png
3,195,0.5,0,0,98489,395,98884,images/run_14e17b72-8e0f-4c88-bd8d-9c3935ef5eeb_fuels-dens_2100_000.png
3,225,0.5,0,0,20131,1661,21792,images/run_6e9d12ef-dc56-457e-9cb7-22360c05076a_fuels-dens_2100_000.png
3,225,0.5,0,0,99804,360,100164,images/run_c2c4e97a-1133-45c6-ad29-ff7b01fd6674_fuels-dens_2100_000.png
3,195,0.5,0,0,97711,370,98081,images/run_b8b049ce-a3a6-4e5b-a7ec-359d3cd362fb_fuels-dens_2100_000.png
3,195,0.5,0,0,22956,207,23163,images/run_97481215-5f15-4fbd-9b37-d7a92e710d24_fuels-dens_2100_000.png
3,195,0.5,0,0,71353,0,71353,images/run_7b895335-33a1-4661-b824-58d9fe74a974_fuels-dens_2100_000.png
3,240,0.5,0,0,69828,0,69828,images/run_ea1f1d0a-ddf1-4db3-a7c0-2bbba43a6f7d_fuels-dens_2100_000.png
3,180,0.5,0,0,94657,334,94991,images/run_9fc25f69-d782-40cc-b883-f97099772950_fuels-dens_2100_000.png
3,180,0.5,0,0,23658,195,23853,images/run_3f3070eb-c4a3-4c9b-924c-fa4c4abbc581_fuels-dens_2100_000.png
3,180,0.5,0,0,69138,0,69138,images/run_bf2e40c7-eaa2-4469-901e-55520d20b50c_fuels-dens_2100_000.png
5,225,0.5,0,0,105058,1397,106455,images/run_b03952c9-8df4-4de3-ba89-ad77c3861836_fuels-dens_2100_000.png
3,240,0.5,0,0,20112,333,20445,images/run_65b35da3-9636-4ab5-94b5-f91ae79ff0db_fuels-dens_2100_000.png
3,175,0.5,0,0,94725,415,95140,images/run_3c222aca-111f-411b-99a2-6b0362f35c70_fuels-dens_2100_000.png
3,175,0.5,0,0,25556,63,25619,images/run_a4a6ad87-c16b-48e0-b9fe-d50fd56febfa_fuels-dens_2100_000.png
3,175,0.5,0,0,68269,0,68269,images/run_39935576-216f-4061-bd74-d6713bad53d9_fuels-dens_2100_000.png
3,255,0.5,0,0,65841,0,65841,images/run_e0897578-7212-4498-8ace-ef166d9b9a5c_fuels-dens_2100_000.png
3,255,0.5,0,0,19859,0,19859,images/run_9d7df319-21c2-42e7-b29f-adf64fd2f799_fuels-dens_2100_000.png
3,255,0.5,0,0,98912,0,98912,images/run_1eefda16-2166-4cce-9422-b7b1f286878b_fuels-dens_2100_000.png
3,180,0.5,0,0,97997,179,98176,images/run_2ce26788-6c03-46b9-ab47-47c195987991_fuels-dens_2100_000.png
3,195,0.5,0,0,71940,0,71940,images/run_0f03c32e-612e-4d85-ae60-7d276ffb21c3_fuels-dens_2100_000.png
3,195,0.5,0,0,22819,844,23663,images/run_51ac92d5-bd85-4d88-996a-55d4f4c793a9_fuels-dens_2100_000.png
8,255,0.5,0,0,106904,350,107254,images/run_fa20ed73-8a0b-40e3-bd3f-bca2ff76e3d0_fuels-dens_2100_000.png